AAAAACTTGCC -> AAAACTTGCCC
AAAACTTGCCC -> AAACTTGCCCA
AAAATTCTTTT -> AAATTCTTTTT
AAACGCCGGCC -> AACGCCGGCCG
AAACGGTCAGA -> AACGGTCAGAG
AAACGGTTGCC -> AACGGTTGCCA
AAACTGTCTGG -> AACTGTCTGGG
AAACTTCTAGG -> AACTTCTAGGC
AAACTTGCCCA -> AACTTGCCCAA
AAAGAAGCAGT -> AAGAAGCAGTG
AAAGAGGATTT -> AAGAGGATTTC
AAAGATCCGAT -> AAGATCCGATA
AAAGCCGTCAT -> AAGCCGTCATG
AAAGCCTTTCA -> AAGCCTTTCAG
AAAGCTACGCA -> AAGCTACGCAG
AAAGCTCTGAC -> AAGCTCTGACT
AAAGCTCTTCA -> AAGCTCTTCAC
AAAGCTTTATT -> AAGCTTTATTA
AAAGGACTCAG -> AAGGACTCAGA
AAAGGTTGTGA -> AAGGTTGTGAC
AAAGTCGAGGT -> AAGTCGAGGTG
AAATCCTGGAT -> AATCCTGGATG
AAATCTTCTTG -> AATCTTCTTGC
AAATGACATCA -> AATGACATCAG
AAATGATCACG -> AATGATCACGT
AAATTCGCCAA -> AATTCGCCAAC
AAATTCTTTTT -> AATTCTTTTTT
AACAAAGCTCT -> ACAAAGCTCTG
AACAACCAGAC -> ACAACCAGACG
AACAACTTTGG -> ACAACTTTGGC
AACACGAGATT -> ACACGAGATTT
AACACGGTATA -> ACACGGTATAA
AACACGGTCAG -> ACACGGTCAGA
AACAGCACGGG -> ACAGCACGGGG
AACAGGCTACA -> ACAGGCTACAG
AACATACCATA -> ACATACCATAT
AACATATGCTA -> ACATATGCTAG
AACATCTCAAA -> ACATCTCAAAA
AACATGGGATA -> ACATGGGATAC
AACCAAGAGAG -> ACCAAGAGAGA
AACCAATTACC -> ACCAATTACCC
AACCAGACGTG -> ACCAGACGTGA
AACCGATCTCC -> ACCGATCTCCA
AACCTACGTTC -> ACCTACGTTCC
AACGACTTCGC -> ACGACTTCGCA
AACGATGCGAG -> ACGATGCGAGG
AACGCCGGCCG -> ACGCCGGCCGT
AACGCTTAAAC -> ACGCTTAAACG
AACGGAGCGTT -> ACGGAGCGTTC
AACGGTCAGAG -> ACGGTCAGAGA
AACGGTGACAA -> ACGGTGACAAA
AACGGTTGCCA -> ACGGTTGCCAC
AACGTCCGATG -> ACGTCCGATGT
AACGTTATTCG -> ACGTTATTCGG
AACGTTGAAGT -> ACGTTGAAGTG
AACTCCACCAA -> ACTCCACCAAG
AACTCGGGCCC -> ACTCGGGCCCG
AACTCGTAATC -> ACTCGTAATCC
AACTGAGGCCT -> ACTGAGGCCTG
AACTGCCCCCT -> ACTGCCCCCTA
AACTGTCTGGG -> ACTGTCTGGGA
AACTTCTAGGC -> ACTTCTAGGCG
AACTTGCCCAA -> ACTTGCCCAAT
AACTTTGGCAG -> ACTTTGGCAGT
AAGAACAAAGC -> AGAACAAAGCT
AAGAAGCAGTG -> AGAAGCAGTGC
AAGAATGACCG -> AGAATGACCGA
AAGACGCCACC -> AGACGCCACCT
AAGACTGAAAT -> AGACTGAAATC
AAGAGAGATGG -> AGAGAGATGGT
AAGAGCTCCGT -> AGAGCTCCGTG
AAGAGGATTTC -> AGAGGATTTCA
AAGATCCGATA -> AGATCCGATAT
AAGATTTACGT -> AGATTTACGTT
AAGCAGTGCAC -> AGCAGTGCACA
AAGCCGTCATG -> AGCCGTCATGC
AAGCCTTTCAG -> AGCCTTTCAGC
AAGCTACGCAG -> AGCTACGCAGG
AAGCTCAAGGT -> AGCTCAAGGTT
AAGCTCTGACT -> AGCTCTGACTA
AAGCTCTTCAC -> AGCTCTTCACG
AAGCTGAGGAA -> AGCTGAGGAAG
AAGCTTTATTA -> AGCTTTATTAA
AAGGACCGTGA -> AGGACCGTGAG
AAGGACGTGTG -> AGGACGTGTGC
AAGGACTCAGA -> AGGACTCAGAA
AAGGAGACGCG -> AGGAGACGCGC
AAGGCTGGGTA -> AGGCTGGGTAA
AAGGGTTCAAC -> AGGGTTCAACA
AAGGTTGTGAC -> AGGTTGTGACC
AAGGTTTTGCA -> AGGTTTTGCAA
AAGTATACCCC -> AGTATACCCCG
AAGTCGAGGTG -> AGTCGAGGTGT
AAGTGAGTTCC -> AGTGAGTTCCA
AAGTGCGCGGT -> AGTGCGCGGTA
AAGTGTCGGTG -> AGTGTCGGTGT
AAGTTCGGTAA -> AGTTCGGTAAC
AATAGAGGGGT -> ATAGAGGGGTG
AATATGTTGCG -> ATATGTTGCGC
AATCCACCGCT -> ATCCACCGCTA
AATCCCTAACG -> ATCCCTAACGT
AATCCTGGATG -> ATCCTGGATGT
AATCGGTTATA -> ATCGGTTATAG
AATCTTCTTGC -> ATCTTCTTGCA
AATGACATCAG -> ATGACATCAGA
AATGACCGACT -> ATGACCGACTT
AATGACTGCGA -> ATGACTGCGAG
AATGATCACGT -> ATGATCACGTC
AATGCACCATG -> ATGCACCATGC
AATGCCACCGT -> ATGCCACCGTG
AATGCGACATA -> ATGCGACATAA
AATGGAAAGTC -> ATGGAAAGTCG
AATGTCGAACT -> ATGTCGAACTC
AATTACCCTCA -> ATTACCCTCAC
AATTCGAACCT -> ATTCGAACCTA
AATTCGCCAAC -> ATTCGCCAACT
AATTCTTTTTT -> ATTCTTTTTTG
AATTGTAAGTA -> ATTGTAAGTAT
ACAAACGGTCA -> CAAACGGTCAG
ACAAAGAAGCA -> CAAAGAAGCAG
ACAAAGCTCTG -> CAAAGCTCTGA
ACAAAGCTTTA -> CAAAGCTTTAT
ACAAATGATCA -> CAAATGATCAC
ACAACCAGACG -> CAACCAGACGT
ACAACTTTGGC -> CAACTTTGGCA
ACAAGATTTAC -> CAAGATTTACG
ACAAGGGTTCA -> CAAGGGTTCAA
ACACAGTTTGT -> CACAGTTTGTG
ACACGACGTAG -> CACGACGTAGT
ACACGAGATTT -> CACGAGATTTA
ACACGGTATAA -> CACGGTATAAC
ACACGGTCAGA -> CACGGTCAGAA
ACACGTTCCAT -> CACGTTCCATA
ACACTAAAGAG -> CACTAAAGAGG
ACACTCTATTA -> CACTCTATTAC
ACAGATGCCTC -> CAGATGCCTCG
ACAGCAACGGT -> CAGCAACGGTG
ACAGCACGGGG -> CAGCACGGGGC
ACAGGCACACG -> CAGGCACACGA
ACAGGCCGATT -> CAGGCCGATTC
ACAGGCTACAG -> CAGGCTACAGG
ACAGTTTGTGA -> CAGTTTGTGAA
ACATAACAACC -> CATAACAACCA
ACATACCATAT -> CATACCATATA
ACATATGCTAG -> CATATGCTAGA
ACATCAGACTC -> CATCAGACTCG
ACATCTCAAAA -> CATCTCAAAAA
ACATGGGATAC -> CATGGGATACA
ACATTCAGCGG -> CATTCAGCGGT
ACCAACATGGG -> CCAACATGGGA
ACCAAGAGAGA -> CCAAGAGAGAT
ACCAAGCTGAG -> CCAAGCTGAGG
ACCAAGTTCGG -> CCAAGTTCGGT
ACCAATTACCC -> CCAATTACCCT
ACCACCCTGAT -> CCACCCTGATG
ACCACGCGAAG -> CCACGCGAAGG
ACCACTTACGA -> CCACTTACGAA
ACCAGACGTGA -> CCAGACGTGAT
ACCAGGCCAGG -> CCAGGCCAGGA
ACCATATAAAT -> CCATATAAATC
ACCATATGCGC -> CCATATGCGCA
ACCATGCACTA -> CCATGCACTAC
ACCCATAACTC -> CCCATAACTCG
ACCCCGCCGCA -> CCCCGCCGCAT
ACCCGCTTATA -> CCCGCTTATAG
ACCCTCACGCA -> CCCTCACGCAT
ACCCTGATGGT -> CCCTGATGGTT
ACCGACTTGTC -> CCGACTTGTCC
ACCGATCTCCA -> CCGATCTCCAG
ACCGATGAGTT -> CCGATGAGTTG
ACCGCTAGGAT -> CCGCTAGGATG
ACCGTGAGAGT -> CCGTGAGAGTC
ACCGTGATATA -> CCGTGATATAC
ACCGTGGTTAG -> CCGTGGTTAGC
ACCTACGTTCC -> CCTACGTTCCT
ACCTACTATGC -> CCTACTATGCA
ACCTCATATCT -> CCTCATATCTT
ACCTCCATCGA -> CCTCCATCGAT
ACCTGAGTGAC -> CCTGAGTGACA
ACCTGGACCCA -> CCTGGACCCAT
ACCTTTATCCG -> CCTTTATCCGG
ACGAAGTGAGT -> CGAAGTGAGTT
ACGAATGCGAC -> CGAATGCGACA
ACGACCAGGCC -> CGACCAGGCCA
ACGACGTAGTG -> CGACGTAGTGT
ACGACGTGAAA -> CGACGTGAAAG
ACGACTTCGCA -> CGACTTCGCAC
ACGAGAATTGT -> CGAGAATTGTA
ACGAGATTTAA -> CGAGATTTAAC
ACGAGCTTATG -> CGAGCTTATGT
ACGATACACTA -> CGATACACTAA
ACGATGCGAGG -> CGATGCGAGGA
ACGCAGGCGCA -> CGCAGGCGCAT
ACGCATAGACT -> CGCATAGACTG
ACGCCACCTGA -> CGCCACCTGAG
ACGCCGGCCGT -> CGCCGGCCGTT
ACGCGAAGGAC -> CGCGAAGGACG
ACGCGCCGGGT -> CGCGCCGGGTT
ACGCTTAAACG -> CGCTTAAACGG
ACGGAGCGTTC -> CGGAGCGTTCG
ACGGGGCTCTC -> CGGGGCTCTCA
ACGGTATAACG -> CGGTATAACGC
ACGGTCAGAAA -> CGGTCAGAAAC
ACGGTCAGAGA -> CGGTCAGAGAT
ACGGTGACAAA -> CGGTGACAAAG
ACGGTTGCCAC -> CGGTTGCCACT
ACGTAGTGTCG -> CGTAGTGTCGA
ACGTCAACACG -> CGTCAACACGG
ACGTCATTAGT -> CGTCATTAGTC
ACGTCCGATGT -> CGTCCGATGTT
ACGTGAAAGCT -> CGTGAAAGCTC
ACGTGATTATC -> CGTGATTATCT
ACGTGTGCTCA -> CGTGTGCTCAA
ACGTTAAGTGC -> CGTTAAGTGCG
ACGTTAGTGAG -> CGTTAGTGAGA
ACGTTATCGGG -> CGTTATCGGGG
ACGTTATTCGG -> CGTTATTCGGT
ACGTTCCATAG -> CGTTCCATAGC
ACGTTCCTAAA -> CGTTCCTAAAA
ACGTTGAAGTG -> CGTTGAAGTGT
ACTAAAGAGGA -> CTAAAGAGGAT
ACTAACATATG -> CTAACATATGC
ACTAACGTTAT -> CTAACGTTATT
ACTACCTTTAT -> CTACCTTTATC
ACTACGTCATT -> CTACGTCATTA
ACTACTTTGGG -> CTACTTTGGGC
ACTAGGGTGCC -> CTAGGGTGCCA
ACTATGATTTA -> CTATGATTTAT
ACTATGCATAA -> CTATGCATAAA
ACTATTCTTAT -> CTATTCTTATG
ACTCAGAAAGC -> CTCAGAAAGCC
ACTCCACCAAG -> CTCCACCAAGT
ACTCGGGCCCG -> CTCGGGCCCGC
ACTCGTAATCC -> CTCGTAATCCC
ACTCGTTCATA -> CTCGTTCATAT
ACTCGTTTGCA -> CTCGTTTGCAG
ACTCTATTACT -> CTCTATTACTC
ACTGAAATCTT -> CTGAAATCTTC
ACTGAATGTCG -> CTGAATGTCGA
ACTGAGGCCTG -> CTGAGGCCTGA
ACTGCAGCTAT -> CTGCAGCTATA
ACTGCCCCCTA -> CTGCCCCCTAG
ACTGCGAGACC -> CTGCGAGACCG
ACTGTCTGGGA -> CTGTCTGGGAT
ACTGTGGCTGC -> CTGTGGCTGCT
ACTTACCTACT -> CTTACCTACTA
ACTTACGAAGT -> CTTACGAAGTG
ACTTCACGAAT -> CTTCACGAATG
ACTTCCCCGAT -> CTTCCCCGATC
ACTTCGCACGA -> CTTCGCACGAT
ACTTCTACGTT -> CTTCTACGTTA
ACTTCTAGGCG -> CTTCTAGGCGA
ACTTGCCCAAT -> CTTGCCCAATC
ACTTGTCCCTT -> CTTGTCCCTTC
ACTTTGGACGA -> CTTTGGACGAG
ACTTTGGCAGT -> CTTTGGCAGTC
ACTTTGGGCAG -> CTTTGGGCAGT
AGAAACTGTCT -> GAAACTGTCTG
AGAAAGCCTTT -> GAAAGCCTTTC
AGAACAAAGCT -> GAACAAAGCTC
AGAAGACTGAA -> GAAGACTGAAA
AGAAGAGCTCC -> GAAGAGCTCCG
AGAAGCAGTGC -> GAAGCAGTGCA
AGAATGACCGA -> GAATGACCGAC
AGAATGACTGC -> GAATGACTGCG
AGAATTGTAAG -> GAATTGTAAGT
AGACCGATGAG -> GACCGATGAGT
AGACCTCCATC -> GACCTCCATCG
AGACGCCACCT -> GACGCCACCTG
AGACGCGCCGG -> GACGCGCCGGG
AGACGTGATTA -> GACGTGATTAT
AGACTCGTTCA -> GACTCGTTCAT
AGACTGAAATC -> GACTGAAATCT
AGACTGTGGCT -> GACTGTGGCTG
AGAGAGATGGT -> GAGAGATGGTA
AGAGATCGAAT -> GAGATCGAATT
AGAGATGGTAT -> GAGATGGTATT
AGAGCAAGGCT -> GAGCAAGGCTG
AGAGCATTATA -> GAGCATTATAT
AGAGCTCCGTG -> GAGCTCCGTGT
AGAGGATTTCA -> GAGGATTTCAT
AGAGGGGTGGG -> GAGGGGTGGGT
AGAGTCTATCA -> GAGTCTATCAT
AGATCCGATAT -> GATCCGATATC
AGATCGAATTC -> GATCGAATTCG
AGATGCCTCGA -> GATGCCTCGAT
AGATGGTATTA -> GATGGTATTAC
AGATGTAGCCG -> GATGTAGCCGT
AGATTAGCCCT -> GATTAGCCCTG
AGATTATGGTG -> GATTATGGTGG
AGATTTAACAG -> GATTTAACAGG
AGATTTACGTT -> GATTTACGTTA
AGCAACGGTGA -> GCAACGGTGAC
AGCAAGGCTGG -> GCAAGGCTGGG
AGCACCACGCG -> GCACCACGCGA
AGCACGGGGCT -> GCACGGGGCTC
AGCAGCGAGGT -> GCAGCGAGGTA
AGCAGTGCACA -> GCAGTGCACAA
AGCATAGCGTC -> GCATAGCGTCC
AGCATTATATC -> GCATTATATCT
AGCCACTATTC -> GCCACTATTCT
AGCCCTGACAC -> GCCCTGACACG
AGCCGGGTGGG -> GCCGGGTGGGC
AGCCGTCATGC -> GCCGTCATGCT
AGCCGTTGTGT -> GCCGTTGTGTA
AGCCTTTCAGC -> GCCTTTCAGCC
AGCGAGGTATA -> GCGAGGTATAG
AGCGGACTAAC -> GCGGACTAACA
AGCGGTAGCAG -> GCGGTAGCAGC
AGCGTACTGCA -> GCGTACTGCAG
AGCGTCCTAAA -> GCGTCCTAAAG
AGCGTTCGTCG -> GCGTTCGTCGA
AGCTACGCAGG -> GCTACGCAGGC
AGCTATACCAC -> GCTATACCACC
AGCTCAAGGTT -> GCTCAAGGTTT
AGCTCCGTGTT -> GCTCCGTGTTG
AGCTCTACGTT -> GCTCTACGTTA
AGCTCTGACTA -> GCTCTGACTAA
AGCTCTTCACG -> GCTCTTCACGA
AGCTGAATGCC -> GCTGAATGCCA
AGCTGAGGAAG -> GCTGAGGAAGG
AGCTGCCACTA -> GCTGCCACTAC
AGCTTATGTCG -> GCTTATGTCGA
AGCTTTATTAA -> GCTTTATTAAA
AGGAAGAACAA -> GGAAGAACAAA
AGGAAGGAGAC -> GGAAGGAGACG
AGGACACTCTA -> GGACACTCTAT
AGGACCGTGAG -> GGACCGTGAGA
AGGACGTGTGC -> GGACGTGTGCT
AGGACTCAGAA -> GGACTCAGAAA
AGGAGACGCGC -> GGAGACGCGCC
AGGAGGGATAA -> GGAGGGATAAC
AGGATGCCGAA -> GGATGCCGAAA
AGGATTTCATT -> GGATTTCATTA
AGGCACACGAC -> GGCACACGACG
AGGCCAGGAGG -> GGCCAGGAGGG
AGGCCGATTCG -> GGCCGATTCGA
AGGCCTGACTA -> GGCCTGACTAT
AGGCGACCGTG -> GGCGACCGTGG
AGGCGCATCGG -> GGCGCATCGGG
AGGCTACAGGC -> GGCTACAGGCA
AGGCTCTTAAC -> GGCTCTTAACA
AGGCTGGGTAA -> GGCTGGGTAAA
AGGGATAACTG -> GGGATAACTGC
AGGGATATTAT -> GGGATATTATA
AGGGCAACGAC -> GGGCAACGACT
AGGGCAGAGCA -> GGGCAGAGCAA
AGGGGCGGTGA -> GGGGCGGTGAA
AGGGGTGGGTT -> GGGGTGGGTTG
AGGGTGCCATG -> GGGTGCCATGG
AGGGTTCAACA -> GGGTTCAACAT
AGGTACCAAGC -> GGTACCAAGCT
AGGTATAGCAT -> GGTATAGCATA
AGGTCCCCTGT -> GGTCCCCTGTG
AGGTCTCTCCT -> GGTCTCTCCTC
AGGTGTTGACC -> GGTGTTGACCC
AGGTTGTGACC -> GGTTGTGACCA
AGGTTTTGCAA -> GGTTTTGCAAC
AGTAAACGCCG -> GTAAACGCCGG
AGTAATATGTT -> GTAATATGTTG
AGTAGAAGACT -> GTAGAAGACTG
AGTATAAGACG -> GTATAAGACGC
AGTATACCCCG -> GTATACCCCGC
AGTCAAGAATG -> GTCAAGAATGA
AGTCGAGGTGT -> GTCGAGGTGTT
AGTCGCTGGGC -> GTCGCTGGGCT
AGTCTATCATC -> GTCTATCATCG
AGTCTCTGATG -> GTCTCTGATGC
AGTCTGGAGCG -> GTCTGGAGCGG
AGTGACAAACG -> GTGACAAACGG
AGTGAGAAGAG -> GTGAGAAGAGC
AGTGAGTTCCA -> GTGAGTTCCAC
AGTGCACAAGG -> GTGCACAAGGG
AGTGCGCGGTA -> GTGCGCGGTAC
AGTGGCAAAGG -> GTGGCAAAGGT
AGTGTCGAGGG -> GTGTCGAGGGG
AGTGTCGGTGT -> GTGTCGGTGTG
AGTTAATGGAA -> GTTAATGGAAA
AGTTATTCATC -> GTTATTCATCC
AGTTCCACTTA -> GTTCCACTTAC
AGTTCGGTAAC -> GTTCGGTAACC
AGTTCTACGAC -> GTTCTACGACG
AGTTCTCATCG -> GTTCTCATCGA
AGTTGTATTTA -> GTTGTATTTAG
AGTTTGTGAAG -> GTTTGTGAAGC
ATAAATCCTGG -> TAAATCCTGGA
ATAAATTCGCC -> TAAATTCGCCA
ATAACAACCAG -> TAACAACCAGA
ATAACACGAGA -> TAACACGAGAT
ATAACACGGTA -> TAACACGGTAT
ATAACGCTTAA -> TAACGCTTAAA
ATAACTCGGGC -> TAACTCGGGCC
ATAACTGCCCC -> TAACTGCCCCC
ATAAGACGCCA -> TAAGACGCCAC
ATACAAATGAT -> TACAAATGATC
ATACACTAAAG -> TACACTAAAGA
ATACATTCAGC -> TACATTCAGCG
ATACCAACATG -> TACCAACATGG
ATACCACCCTG -> TACCACCCTGA
ATACCATATAA -> TACCATATAAA
ATACCCCGCCG -> TACCCCGCCGC
ATACTAGGGTG -> TACTAGGGTGC
ATAGACTGTGG -> TAGACTGTGGC
ATAGAGGGGTG -> TAGAGGGGTGG
ATAGCACCACG -> TAGCACCACGC
ATAGCATAGCG -> TAGCATAGCGT
ATAGCCGGGTG -> TAGCCGGGTGG
ATAGCGTCCTA -> TAGCGTCCTAA
ATAGCTGCCAC -> TAGCTGCCACT
ATAGTATAAGA -> TAGTATAAGAC
ATAGTTATTCA -> TAGTTATTCAT
ATATAAATCCT -> TATAAATCCTG
ATATACATTCA -> TATACATTCAG
ATATCCAAGGA -> TATCCAAGGAC
ATATCTGGTGG -> TATCTGGTGGA
ATATCTTTCAG -> TATCTTTCAGG
ATATGAATCCA -> TATGAATCCAC
ATATGCGCATC -> TATGCGCATCA
ATATGCTAGAT -> TATGCTAGATG
ATATGTTGCGC -> TATGTTGCGCG
ATATTATAACA -> TATTATAACAC
ATCACGTCAAC -> TCACGTCAACA
ATCAGACTCGT -> TCAGACTCGTT
ATCAGATTATG -> TCAGATTATGG
ATCATCGTTGG -> TCATCGTTGGG
ATCATGTTCGA -> TCATGTTCGAA
ATCCAAGGACC -> TCCAAGGACCG
ATCCACCGCTA -> TCCACCGCTAG
ATCCATTTTAT -> TCCATTTTATC
ATCCCTAACGT -> TCCCTAACGTT
ATCCGATATCC -> TCCGATATCCA
ATCCGGACCAC -> TCCGGACCACT
ATCCTACCTCA -> TCCTACCTCAT
ATCCTGGATGT -> TCCTGGATGTA
ATCGAATTCGA -> TCGAATTCGAA
ATCGACTTCTA -> TCGACTTCTAC
ATCGACTTTGG -> TCGACTTTGGA
ATCGAGGGATA -> TCGAGGGATAT
ATCGATCAGAT -> TCGATCAGATT
ATCGCCAGGCT -> TCGCCAGGCTC
ATCGGGGCTAC -> TCGGGGCTACT
ATCGGGGTTCA -> TCGGGGTTCAA
ATCGGTTATAG -> TCGGTTATAGC
ATCGTTGGGTA -> TCGTTGGGTAG
ATCTCAAAAAC -> TCTCAAAAACT
ATCTCCAGCTG -> TCTCCAGCTGA
ATCTCCCCTGT -> TCTCCCCTGTA
ATCTGGTGGAT -> TCTGGTGGATC
ATCTGTTTAAA -> TCTGTTTAAAG
ATCTTCTACAA -> TCTTCTACAAA
ATCTTCTTGCA -> TCTTCTTGCAG
ATCTTTCAGGT -> TCTTTCAGGTA
ATGAATCCACC -> TGAATCCACCG
ATGACATCAGA -> TGACATCAGAC
ATGACCGACTT -> TGACCGACTTG
ATGACTGCGAG -> TGACTGCGAGA
ATGAGCGTACT -> TGAGCGTACTG
ATGAGTTGTAT -> TGAGTTGTATT
ATGATCACGTC -> TGATCACGTCA
ATGATTTATCG -> TGATTTATCGA
ATGCACAGATG -> TGCACAGATGC
ATGCACCATGC -> TGCACCATGCA
ATGCACTACGT -> TGCACTACGTC
ATGCATAAATT -> TGCATAAATTC
ATGCCACCGTG -> TGCCACCGTGA
ATGCCGAAAGG -> TGCCGAAAGGA
ATGCCTCGATG -> TGCCTCGATGA
ATGCGACATAA -> TGCGACATAAC
ATGCGAGGAAG -> TGCGAGGAAGA
ATGCGCATCAT -> TGCGCATCATG
ATGCTAGATGT -> TGCTAGATGTA
ATGCTCTAGTT -> TGCTCTAGTTC
ATGGAAAGTCG -> TGGAAAGTCGA
ATGGCATAGTA -> TGGCATAGTAT
ATGGGATACAA -> TGGGATACAAA
ATGGGATGGGT -> TGGGATGGGTA
ATGGGTAGTAG -> TGGGTAGTAGA
ATGGTATTACA -> TGGTATTACAC
ATGGTGGTACC -> TGGTGGTACCT
ATGGTTAGGTC -> TGGTTAGGTCT
ATGTAGCCGTT -> TGTAGCCGTTG
ATGTATAGCAC -> TGTATAGCACC
ATGTCGAACTC -> TGTCGAACTCG
ATGTCGATGTG -> TGTCGATGTGG
ATGTGGCAGTC -> TGTGGCAGTCA
ATGTTCGAACG -> TGTTCGAACGG
ATGTTGCGCGC -> TGTTGCGCGCC
ATGTTGTCCGA -> TGTTGTCCGAC
ATTAAATGACA -> TTAAATGACAT
ATTAATAGAGG -> TTAATAGAGGG
ATTACACAGTT -> TTACACAGTTT
ATTACCCTCAC -> TTACCCTCACG
ATTACTCGTTT -> TTACTCGTTTG
ATTAGCCCTGA -> TTAGCCCTGAC
ATTAGGGCAGA -> TTAGGGCAGAG
ATTAGTCTCTG -> TTAGTCTCTGA
ATTATAACACG -> TTATAACACGA
ATTATACCAAC -> TTATACCAACA
ATTATATCTGG -> TTATATCTGGT
ATTATCTCCCC -> TTATCTCCCCT
ATTATGGTGGT -> TTATGGTGGTA
ATTCAGCGGTA -> TTCAGCGGTAG
ATTCATCCTAC -> TTCATCCTACC
ATTCGAACCTA -> TTCGAACCTAC
ATTCGAGGACA -> TTCGAGGACAC
ATTCGATACTA -> TTCGATACTAG
ATTCGCCAACT -> TTCGCCAACTC
ATTCGGTGGGA -> TTCGGTGGGAC
ATTCTTATGGG -> TTCTTATGGGA
ATTCTTTTTTG -> TTCTTTTTTGG
ATTGTAAGTAT -> TTGTAAGTATA
ATTTAACAGGC -> TTTAACAGGCT
ATTTACGTTAA -> TTTACGTTAAG
ATTTAGACCTC -> TTTAGACCTCC
ATTTATCGACT -> TTTATCGACTT
ATTTCATTATA -> TTTCATTATAC
ATTTTATCGAC -> TTTTATCGACT
ATTTTTCTTGG -> TTTTTCTTGGC
CAAAAACTTGC -> AAAAACTTGCC
CAAACGGTCAG -> AAACGGTCAGA
CAAAGAAGCAG -> AAAGAAGCAGT
CAAAGCTCTGA -> AAAGCTCTGAC
CAAAGCTTTAT -> AAAGCTTTATT
CAAAGGTTGTG -> AAAGGTTGTGA
CAAATGATCAC -> AAATGATCACG
CAACAACTTTG -> AACAACTTTGG
CAACACGGTCA -> AACACGGTCAG
CAACATACCAT -> AACATACCATA
CAACATCTCAA -> AACATCTCAAA
CAACATGGGAT -> AACATGGGATA
CAACCAGACGT -> AACCAGACGTG
CAACCGATCTC -> AACCGATCTCC
CAACGACTTCG -> AACGACTTCGC
CAACGATGCGA -> AACGATGCGAG
CAACGGTGACA -> AACGGTGACAA
CAACTCCACCA -> AACTCCACCAA
CAACTTTGGCA -> AACTTTGGCAG
CAAGAATGACC -> AAGAATGACCG
CAAGAGAGATG -> AAGAGAGATGG
CAAGATTTACG -> AAGATTTACGT
CAAGCTGAGGA -> AAGCTGAGGAA
CAAGGACCGTG -> AAGGACCGTGA
CAAGGCTGGGT -> AAGGCTGGGTA
CAAGGGTTCAA -> AAGGGTTCAAC
CAAGGTTTTGC -> AAGGTTTTGCA
CAAGTTCGGTA -> AAGTTCGGTAA
CAATCGGTTAT -> AATCGGTTATA
CAATGCACCAT -> AATGCACCATG
CAATTACCCTC -> AATTACCCTCA
CACAAGGGTTC -> ACAAGGGTTCA
CACACGACGTA -> ACACGACGTAG
CACAGATGCCT -> ACAGATGCCTC
CACAGTTTGTG -> ACAGTTTGTGA
CACCAAGTTCG -> ACCAAGTTCGG
CACCACGCGAA -> ACCACGCGAAG
CACCATGCACT -> ACCATGCACTA
CACCCTGATGG -> ACCCTGATGGT
CACCGCTAGGA -> ACCGCTAGGAT
CACCGTGATAT -> ACCGTGATATA
CACCTGAGTGA -> ACCTGAGTGAC
CACGAATGCGA -> ACGAATGCGAC
CACGACGTAGT -> ACGACGTAGTG
CACGAGAATTG -> ACGAGAATTGT
CACGAGATTTA -> ACGAGATTTAA
CACGATACACT -> ACGATACACTA
CACGCATAGAC -> ACGCATAGACT
CACGCGAAGGA -> ACGCGAAGGAC
CACGGGGCTCT -> ACGGGGCTCTC
CACGGTATAAC -> ACGGTATAACG
CACGGTCAGAA -> ACGGTCAGAAA
CACGTCAACAC -> ACGTCAACACG
CACGTTCCATA -> ACGTTCCATAG
CACTAAAGAGG -> ACTAAAGAGGA
CACTACGTCAT -> ACTACGTCATT
CACTACTTTGG -> ACTACTTTGGG
CACTATTCTTA -> ACTATTCTTAT
CACTCTATTAC -> ACTCTATTACT
CACTTACCTAC -> ACTTACCTACT
CACTTACGAAG -> ACTTACGAAGT
CACTTCACGAA -> ACTTCACGAAT
CACTTCCCCGA -> ACTTCCCCGAT
CAGAAACTGTC -> AGAAACTGTCT
CAGAAAGCCTT -> AGAAAGCCTTT
CAGACGTGATT -> AGACGTGATTA
CAGACTCGTTC -> AGACTCGTTCA
CAGAGATCGAA -> AGAGATCGAAT
CAGAGCAAGGC -> AGAGCAAGGCT
CAGATGCCTCG -> AGATGCCTCGA
CAGATTATGGT -> AGATTATGGTG
CAGCAACGGTG -> AGCAACGGTGA
CAGCACGGGGC -> AGCACGGGGCT
CAGCCACTATT -> AGCCACTATTC
CAGCGAGGTAT -> AGCGAGGTATA
CAGCGGTAGCA -> AGCGGTAGCAG
CAGCTATACCA -> AGCTATACCAC
CAGCTGAATGC -> AGCTGAATGCC
CAGGAGGGATA -> AGGAGGGATAA
CAGGCACACGA -> AGGCACACGAC
CAGGCCAGGAG -> AGGCCAGGAGG
CAGGCCGATTC -> AGGCCGATTCG
CAGGCGCATCG -> AGGCGCATCGG
CAGGCTACAGG -> AGGCTACAGGC
CAGGCTCTTAA -> AGGCTCTTAAC
CAGGGCAACGA -> AGGGCAACGAC
CAGGTACCAAG -> AGGTACCAAGC
CAGTAATATGT -> AGTAATATGTT
CAGTCAAGAAT -> AGTCAAGAATG
CAGTCGCTGGG -> AGTCGCTGGGC
CAGTGCACAAG -> AGTGCACAAGG
CAGTTAATGGA -> AGTTAATGGAA
CAGTTCTCATC -> AGTTCTCATCG
CAGTTTGTGAA -> AGTTTGTGAAG
CATAAATTCGC -> ATAAATTCGCC
CATAACAACCA -> ATAACAACCAG
CATAACTCGGG -> ATAACTCGGGC
CATACCATATA -> ATACCATATAA
CATAGACTGTG -> ATAGACTGTGG
CATAGCGTCCT -> ATAGCGTCCTA
CATAGCTGCCA -> ATAGCTGCCAC
CATAGTATAAG -> ATAGTATAAGA
CATATAAATCC -> ATATAAATCCT
CATATCTTTCA -> ATATCTTTCAG
CATATGAATCC -> ATATGAATCCA
CATATGCGCAT -> ATATGCGCATC
CATATGCTAGA -> ATATGCTAGAT
CATCAGACTCG -> ATCAGACTCGT
CATCATGTTCG -> ATCATGTTCGA
CATCCTACCTC -> ATCCTACCTCA
CATCGAGGGAT -> ATCGAGGGATA
CATCGATCAGA -> ATCGATCAGAT
CATCGGGGTTC -> ATCGGGGTTCA
CATCGTTGGGT -> ATCGTTGGGTA
CATCTCAAAAA -> ATCTCAAAAAC
CATCTTCTACA -> ATCTTCTACAA
CATGCACTACG -> ATGCACTACGT
CATGCTCTAGT -> ATGCTCTAGTT
CATGGCATAGT -> ATGGCATAGTA
CATGGGATACA -> ATGGGATACAA
CATGTTCGAAC -> ATGTTCGAACG
CATTAGGGCAG -> ATTAGGGCAGA
CATTAGTCTCT -> ATTAGTCTCTG
CATTATACCAA -> ATTATACCAAC
CATTATATCTG -> ATTATATCTGG
CATTCAGCGGT -> ATTCAGCGGTA
CATTTTATCGA -> ATTTTATCGAC
CCAACATGGGA -> CAACATGGGAT
CCAACTCCACC -> CAACTCCACCA
CCAAGAGAGAT -> CAAGAGAGATG
CCAAGCTGAGG -> CAAGCTGAGGA
CCAAGGACCGT -> CAAGGACCGTG
CCAAGTTCGGT -> CAAGTTCGGTA
CCAATCGGTTA -> CAATCGGTTAT
CCAATTACCCT -> CAATTACCCTC
CCACCAAGTTC -> CACCAAGTTCG
CCACCCTGATG -> CACCCTGATGG
CCACCGCTAGG -> CACCGCTAGGA
CCACCGTGATA -> CACCGTGATAT
CCACCTGAGTG -> CACCTGAGTGA
CCACGCGAAGG -> CACGCGAAGGA
CCACTACTTTG -> CACTACTTTGG
CCACTATTCTT -> CACTATTCTTA
CCACTTACCTA -> CACTTACCTAC
CCACTTACGAA -> CACTTACGAAG
CCACTTCACGA -> CACTTCACGAA
CCAGACGTGAT -> CAGACGTGATT
CCAGCTGAATG -> CAGCTGAATGC
CCAGGAGGGAT -> CAGGAGGGATA
CCAGGCCAGGA -> CAGGCCAGGAG
CCAGGCTCTTA -> CAGGCTCTTAA
CCATAACTCGG -> CATAACTCGGG
CCATAGCTGCC -> CATAGCTGCCA
CCATATAAATC -> CATATAAATCC
CCATATGCGCA -> CATATGCGCAT
CCATCGATCAG -> CATCGATCAGA
CCATGCACTAC -> CATGCACTACG
CCATGGCATAG -> CATGGCATAGT
CCATTTTATCG -> CATTTTATCGA
CCCAATCGGTT -> CCAATCGGTTA
CCCATAACTCG -> CCATAACTCGG
CCCCCTAGATT -> CCCCTAGATTA
CCCCGATCTGT -> CCCGATCTGTT
CCCCGCCGCAT -> CCCGCCGCATC
CCCCTAGATTA -> CCCTAGATTAG
CCCCTGTAGGT -> CCCTGTAGGTC
CCCCTGTGCGA -> CCCTGTGCGAC
CCCGATCTGTT -> CCGATCTGTTT
CCCGCAGTTCT -> CCGCAGTTCTC
CCCGCCGCATC -> CCGCCGCATCT
CCCGCTTATAG -> CCGCTTATAGT
CCCGTGCTCAA -> CCGTGCTCAAC
CCCTAACGTTG -> CCTAACGTTGA
CCCTAGATTAG -> CCTAGATTAGC
CCCTCACGCAT -> CCTCACGCATA
CCCTGACACGT -> CCTGACACGTT
CCCTGATGGTT -> CCTGATGGTTA
CCCTGTAGGTC -> CCTGTAGGTCC
CCCTGTGCGAC -> CCTGTGCGACG
CCCTTCGATTA -> CCTTCGATTAA
CCGAAAGGACT -> CGAAAGGACTC
CCGACAGCAAC -> CGACAGCAACG
CCGACTTGTCC -> CGACTTGTCCC
CCGATATCCAA -> CGATATCCAAG
CCGATCTCCAG -> CGATCTCCAGC
CCGATCTGTTT -> CGATCTGTTTA
CCGATGAGTTG -> CGATGAGTTGT
CCGATGTTGTC -> CGATGTTGTCC
CCGATTCGAGG -> CGATTCGAGGA
CCGCAGTTCTC -> CGCAGTTCTCA
CCGCATCTTCT -> CGCATCTTCTA
CCGCCGCATCT -> CGCCGCATCTT
CCGCTAGGATG -> CGCTAGGATGC
CCGCTTATAGT -> CGCTTATAGTT
CCGGACCACTT -> CGGACCACTTA
CCGGATTCGAT -> CGGATTCGATA
CCGGCCGTTCA -> CGGCCGTTCAA
CCGGGTGGGCT -> CGGGTGGGCTA
CCGGGTTCGAA -> CGGGTTCGAAC
CCGTCATGCTC -> CGTCATGCTCT
CCGTGAGAGTC -> CGTGAGAGTCT
CCGTGATATAC -> CGTGATATACA
CCGTGCTCAAC -> CGTGCTCAACA
CCGTGGTTAGC -> CGTGGTTAGCT
CCGTGTTGTAC -> CGTGTTGTACT
CCGTTCAACGA -> CGTTCAACGAT
CCGTTGTGTAC -> CGTTGTGTACA
CCTAAAATTCT -> CTAAAATTCTT
CCTAAAGCTAC -> CTAAAGCTACG
CCTAACGTTGA -> CTAACGTTGAA
CCTACCTCATA -> CTACCTCATAT
CCTACGTTCCT -> CTACGTTCCTA
CCTACTATGCA -> CTACTATGCAT
CCTAGATTAGC -> CTAGATTAGCC
CCTCACGCATA -> CTCACGCATAG
CCTCATATCTT -> CTCATATCTTT
CCTCCATCGAT -> CTCCATCGATC
CCTCGATGAGC -> CTCGATGAGCG
CCTCGCCGGAT -> CTCGCCGGATT
CCTGACACGTT -> CTGACACGTTC
CCTGACTATGA -> CTGACTATGAT
CCTGAGTGACA -> CTGAGTGACAA
CCTGATGGTTA -> CTGATGGTTAG
CCTGGACCCAT -> CTGGACCCATA
CCTGGATGTAT -> CTGGATGTATA
CCTGTAGGTCC -> CTGTAGGTCCC
CCTGTGCGACG -> CTGTGCGACGA
CCTTCGATTAA -> CTTCGATTAAT
CCTTTATCCGG -> CTTTATCCGGA
CCTTTCAGCCA -> CTTTCAGCCAC
CGAAAGGACTC -> GAAAGGACTCA
CGAACCAAGAG -> GAACCAAGAGA
CGAACCTACGT -> GAACCTACGTT
CGAACGGAGCG -> GAACGGAGCGT
CGAACTCGTAA -> GAACTCGTAAT
CGAAGGACGTG -> GAAGGACGTGT
CGAAGTGAGTT -> GAAGTGAGTTC
CGAATGCGACA -> GAATGCGACAT
CGAATTCGAAC -> GAATTCGAACC
CGACAGCAACG -> GACAGCAACGG
CGACATAACAA -> GACATAACAAC
CGACCAGGCCA -> GACCAGGCCAG
CGACCGTGGTT -> GACCGTGGTTA
CGACGACCAGG -> GACGACCAGGC
CGACGTAGTGT -> GACGTAGTGTC
CGACGTGAAAG -> GACGTGAAAGC
CGACTTCGCAC -> GACTTCGCACG
CGACTTCTACG -> GACTTCTACGT
CGACTTGTCCC -> GACTTGTCCCT
CGACTTTGGAC -> GACTTTGGACG
CGAGAATTGTA -> GAGAATTGTAA
CGAGACCGATG -> GAGACCGATGA
CGAGATTTAAC -> GAGATTTAACA
CGAGCTTATGT -> GAGCTTATGTC
CGAGGAAGAAC -> GAGGAAGAACA
CGAGGACACTC -> GAGGACACTCT
CGAGGGATATT -> GAGGGATATTA
CGAGGGGCGGT -> GAGGGGCGGTG
CGAGGTATAGC -> GAGGTATAGCA
CGAGGTGTTGA -> GAGGTGTTGAC
CGATACACTAA -> GATACACTAAA
CGATACTAGGG -> GATACTAGGGT
CGATATCCAAG -> GATATCCAAGG
CGATCAGATTA -> GATCAGATTAT
CGATCCATTTT -> GATCCATTTTA
CGATCTCCAGC -> GATCTCCAGCT
CGATCTGTTTA -> GATCTGTTTAA
CGATGAGCGTA -> GATGAGCGTAC
CGATGAGTTGT -> GATGAGTTGTA
CGATGCGAGGA -> GATGCGAGGAA
CGATGTGGCAG -> GATGTGGCAGT
CGATGTTGTCC -> GATGTTGTCCG
CGATTAATAGA -> GATTAATAGAG
CGATTCGAGGA -> GATTCGAGGAC
CGCACGATACA -> GCACGATACAC
CGCAGGCGCAT -> GCAGGCGCATC
CGCAGTTCTCA -> GCAGTTCTCAT
CGCATAGACTG -> GCATAGACTGT
CGCATCATGTT -> GCATCATGTTC
CGCATCGGGGT -> GCATCGGGGTT
CGCATCTTCTA -> GCATCTTCTAC
CGCCAACTCCA -> GCCAACTCCAC
CGCCACCTGAG -> GCCACCTGAGT
CGCCAGGCTCT -> GCCAGGCTCTT
CGCCCGTGCTC -> GCCCGTGCTCA
CGCCGCATCTT -> GCCGCATCTTC
CGCCGGATTCG -> GCCGGATTCGA
CGCCGGCCGTT -> GCCGGCCGTTC
CGCCGGGTTCG -> GCCGGGTTCGA
CGCGAAGGACG -> GCGAAGGACGT
CGCGCCCGTGC -> GCGCCCGTGCT
CGCGCCGGGTT -> GCGCCGGGTTC
CGCGGTACAGG -> GCGGTACAGGC
CGCTAGGATGC -> GCTAGGATGCC
CGCTGGGCTTT -> GCTGGGCTTTG
CGCTTAAACGG -> GCTTAAACGGT
CGCTTAAAGAT -> GCTTAAAGATC
CGCTTATAGTT -> GCTTATAGTTA
CGGACCACTTA -> GGACCACTTAC
CGGACTAACAT -> GGACTAACATA
CGGAGCGTTCG -> GGAGCGTTCGT
CGGATTCGATA -> GGATTCGATAC
CGGCCGTTCAA -> GGCCGTTCAAC
CGGGCCCGCAG -> GGGCCCGCAGT
CGGGGCTACTG -> GGGGCTACTGA
CGGGGCTCTCA -> GGGGCTCTCAT
CGGGGTTCAAC -> GGGGTTCAACA
CGGGTGGGCTA -> GGGTGGGCTAG
CGGGTTCGAAC -> GGGTTCGAACC
CGGTAACCAAT -> GGTAACCAATT
CGGTACAGGCC -> GGTACAGGCCG
CGGTAGCAGCG -> GGTAGCAGCGA
CGGTATAACGC -> GGTATAACGCT
CGGTCAGAAAC -> GGTCAGAAACT
CGGTCAGAGAT -> GGTCAGAGATC
CGGTGAACTGA -> GGTGAACTGAG
CGGTGACAAAG -> GGTGACAAAGA
CGGTGGGACTA -> GGTGGGACTAG
CGGTGTGTTAA -> GGTGTGTTAAC
CGGTTATAGCC -> GGTTATAGCCG
CGGTTGCCACT -> GGTTGCCACTT
CGTAATCCCTA -> GTAATCCCTAA
CGTACTGCAGC -> GTACTGCAGCT
CGTAGTGTCGA -> GTAGTGTCGAG
CGTCAACACGG -> GTCAACACGGT
CGTCATGCTCT -> GTCATGCTCTA
CGTCATTAGTC -> GTCATTAGTCT
CGTCCGATGTT -> GTCCGATGTTG
CGTCCTAAAGC -> GTCCTAAAGCT
CGTCGATCCAT -> GTCGATCCATT
CGTGAAAGCTC -> GTGAAAGCTCT
CGTGAGAGTCT -> GTGAGAGTCTA
CGTGATATACA -> GTGATATACAT
CGTGATTATCT -> GTGATTATCTC
CGTGCTCAACA -> GTGCTCAACAA
CGTGGTTAGCT -> GTGGTTAGCTC
CGTGTGCTCAA -> GTGTGCTCAAT
CGTGTTGTACT -> GTGTTGTACTA
CGTTAAGTGCG -> GTTAAGTGCGC
CGTTAGTGAGA -> GTTAGTGAGAA
CGTTATCGGGG -> GTTATCGGGGC
CGTTATTCGGT -> GTTATTCGGTG
CGTTCAACGAT -> GTTCAACGATG
CGTTCATATGA -> GTTCATATGAA
CGTTCCATAGC -> GTTCCATAGCT
CGTTCCTAAAA -> GTTCCTAAAAT
CGTTCGTCGAT -> GTTCGTCGATC
CGTTGAAGTGT -> GTTGAAGTGTC
CGTTGGGTAGA -> GTTGGGTAGAG
CGTTGTGTACA -> GTTGTGTACAA
CGTTTGCAGTA -> GTTTGCAGTAA
CTAAAATTCTT -> TAAAATTCTTT
CTAAAGAGGAT -> TAAAGAGGATT
CTAAAGCTACG -> TAAAGCTACGC
CTAACATATGC -> TAACATATGCT
CTAACGTTATT -> TAACGTTATTC
CTAACGTTGAA -> TAACGTTGAAG
CTACAAAGCTT -> TACAAAGCTTT
CTACAGGCACA -> TACAGGCACAC
CTACCTCATAT -> TACCTCATATC
CTACCTTTATC -> TACCTTTATCC
CTACGACGTGA -> TACGACGTGAA
CTACGCAGGCG -> TACGCAGGCGC
CTACGTCATTA -> TACGTCATTAG
CTACGTTAGTG -> TACGTTAGTGA
CTACGTTATCG -> TACGTTATCGG
CTACGTTCCTA -> TACGTTCCTAA
CTACTATGCAT -> TACTATGCATA
CTACTGAATGT -> TACTGAATGTC
CTACTTTGGGC -> TACTTTGGGCA
CTAGAATGACT -> TAGAATGACTG
CTAGATGTAGC -> TAGATGTAGCC
CTAGATTAGCC -> TAGATTAGCCC
CTAGGATGCCG -> TAGGATGCCGA
CTAGGCGACCG -> TAGGCGACCGT
CTAGGGTGCCA -> TAGGGTGCCAT
CTAGTCTGGAG -> TAGTCTGGAGC
CTAGTTCTACG -> TAGTTCTACGA
CTATACCACCC -> TATACCACCCT
CTATCATCGTT -> TATCATCGTTG
CTATGATTTAT -> TATGATTTATC
CTATGCATAAA -> TATGCATAAAT
CTATTACTCGT -> TATTACTCGTT
CTATTCTTATG -> TATTCTTATGG
CTCAAAAACTT -> TCAAAAACTTG
CTCAACAACTT -> TCAACAACTTT
CTCAAGGTTTT -> TCAAGGTTTTG
CTCAATGCACC -> TCAATGCACCA
CTCACGCATAG -> TCACGCATAGA
CTCAGAAAGCC -> TCAGAAAGCCT
CTCATATCTTT -> TCATATCTTTC
CTCATCGAGGG -> TCATCGAGGGA
CTCATTAGGGC -> TCATTAGGGCA
CTCCACCAAGT -> TCCACCAAGTT
CTCCAGCTGAA -> TCCAGCTGAAT
CTCCATCGATC -> TCCATCGATCA
CTCCCCTGTAG -> TCCCCTGTAGG
CTCCGTGTTGT -> TCCGTGTTGTA
CTCCTCGCCGG -> TCCTCGCCGGA
CTCGATGAGCG -> TCGATGAGCGT
CTCGCCGGATT -> TCGCCGGATTC
CTCGGGCCCGC -> TCGGGCCCGCA
CTCGTAATCCC -> TCGTAATCCCT
CTCGTTCATAT -> TCGTTCATATG
CTCGTTTGCAG -> TCGTTTGCAGT
CTCTACGTTAG -> TCTACGTTAGT
CTCTAGTTCTA -> TCTAGTTCTAC
CTCTATTACTC -> TCTATTACTCG
CTCTCATTAGG -> TCTCATTAGGG
CTCTCCTCGCC -> TCTCCTCGCCG
CTCTGACTAAC -> TCTGACTAACG
CTCTGATGCAC -> TCTGATGCACA
CTCTTAACAGC -> TCTTAACAGCA
CTCTTCACGAG -> TCTTCACGAGA
CTGAAATCTTC -> TGAAATCTTCT
CTGAATGCCAC -> TGAATGCCACC
CTGAATGTCGA -> TGAATGTCGAA
CTGACACGTTC -> TGACACGTTCC
CTGACTAACGT -> TGACTAACGTT
CTGACTATGAT -> TGACTATGATT
CTGAGGAAGGA -> TGAGGAAGGAG
CTGAGGCCTGA -> TGAGGCCTGAC
CTGAGTGACAA -> TGAGTGACAAA
CTGATGCACAG -> TGATGCACAGA
CTGATGGTTAG -> TGATGGTTAGG
CTGCAGCTATA -> TGCAGCTATAC
CTGCCACTACT -> TGCCACTACTT
CTGCCCCCTAG -> TGCCCCCTAGA
CTGCGAGACCG -> TGCGAGACCGA
CTGCTAGTCTG -> TGCTAGTCTGG
CTGCTGCTAGT -> TGCTGCTAGTC
CTGGACCCATA -> TGGACCCATAA
CTGGAGCGGAC -> TGGAGCGGACT
CTGGATGTATA -> TGGATGTATAG
CTGGATTTTTC -> TGGATTTTTCT
CTGGGATAACA -> TGGGATAACAC
CTGGGCTTTGT -> TGGGCTTTGTT
CTGGGTAAACT -> TGGGTAAACTT
CTGGTGGATCG -> TGGTGGATCGC
CTGTAGGTCCC -> TGTAGGTCCCC
CTGTCTGGGAT -> TGTCTGGGATA
CTGTGCGACGA -> TGTGCGACGAC
CTGTGGCTGCT -> TGTGGCTGCTG
CTGTTTAAAGC -> TGTTTAAAGCC
CTTAAACGGTT -> TTAAACGGTTG
CTTAAAGATCC -> TTAAAGATCCG
CTTAACAGCAC -> TTAACAGCACG
CTTACCTACTA -> TTACCTACTAT
CTTACGAAGTG -> TTACGAAGTGA
CTTATAGTTAT -> TTATAGTTATT
CTTATGGGATG -> TTATGGGATGG
CTTATGTCGAT -> TTATGTCGATG
CTTCACGAATG -> TTCACGAATGC
CTTCACGAGAA -> TTCACGAGAAT
CTTCCCCGATC -> TTCCCCGATCT
CTTCGATTAAT -> TTCGATTAATA
CTTCGCACGAT -> TTCGCACGATA
CTTCTACAAAG -> TTCTACAAAGC
CTTCTACGTTA -> TTCTACGTTAT
CTTCTAGGCGA -> TTCTAGGCGAC
CTTCTTGCAGG -> TTCTTGCAGGG
CTTGCAGGGCA -> TTGCAGGGCAA
CTTGCCCAATC -> TTGCCCAATCG
CTTGGCACTTC -> TTGGCACTTCC
CTTGTCCCTTC -> TTGTCCCTTCG
CTTTATCCGGA -> TTTATCCGGAC
CTTTATTAAAT -> TTTATTAAATG
CTTTCAGCCAC -> TTTCAGCCACT
CTTTCAGGTAC -> TTTCAGGTACC
CTTTGGACGAG -> TTTGGACGAGC
CTTTGGCAGTC -> TTTGGCAGTCG
CTTTGGGCAGT -> TTTGGGCAGTT
CTTTGTTGTCT -> TTTGTTGTCTG
CTTTTTTGGAG -> TTTTTTGGAGT
GAAACTGTCTG -> AAACTGTCTGG
GAAAGCCTTTC -> AAAGCCTTTCA
GAAAGCTCTTC -> AAAGCTCTTCA
GAAAGGACTCA -> AAAGGACTCAG
GAAAGTCGAGG -> AAAGTCGAGGT
GAAATCTTCTT -> AAATCTTCTTG
GAACAAAGCTC -> AACAAAGCTCT
GAACCAAGAGA -> AACCAAGAGAG
GAACCTACGTT -> AACCTACGTTC
GAACGGAGCGT -> AACGGAGCGTT
GAACTCGTAAT -> AACTCGTAATC
GAACTGAGGCC -> AACTGAGGCCT
GAAGAACAAAG -> AAGAACAAAGC
GAAGACTGAAA -> AAGACTGAAAT
GAAGAGCTCCG -> AAGAGCTCCGT
GAAGCAGTGCA -> AAGCAGTGCAC
GAAGCTCAAGG -> AAGCTCAAGGT
GAAGGACGTGT -> AAGGACGTGTG
GAAGGAGACGC -> AAGGAGACGCG
GAAGTGAGTTC -> AAGTGAGTTCC
GAAGTGTCGGT -> AAGTGTCGGTG
GAATCCACCGC -> AATCCACCGCT
GAATGACCGAC -> AATGACCGACT
GAATGACTGCG -> AATGACTGCGA
GAATGCCACCG -> AATGCCACCGT
GAATGCGACAT -> AATGCGACATA
GAATGTCGAAC -> AATGTCGAACT
GAATTCGAACC -> AATTCGAACCT
GAATTGTAAGT -> AATTGTAAGTA
GACAAACGGTC -> ACAAACGGTCA
GACAAAGAAGC -> ACAAAGAAGCA
GACACGTTCCA -> ACACGTTCCAT
GACACTCTATT -> ACACTCTATTA
GACAGCAACGG -> ACAGCAACGGT
GACATAACAAC -> ACATAACAACC
GACATCAGACT -> ACATCAGACTC
GACCACTTACG -> ACCACTTACGA
GACCAGGCCAG -> ACCAGGCCAGG
GACCATATGCG -> ACCATATGCGC
GACCCATAACT -> ACCCATAACTC
GACCCGCTTAT -> ACCCGCTTATA
GACCGACTTGT -> ACCGACTTGTC
GACCGATGAGT -> ACCGATGAGTT
GACCGTGAGAG -> ACCGTGAGAGT
GACCGTGGTTA -> ACCGTGGTTAG
GACCTCCATCG -> ACCTCCATCGA
GACGACCAGGC -> ACGACCAGGCC
GACGAGCTTAT -> ACGAGCTTATG
GACGCCACCTG -> ACGCCACCTGA
GACGCGCCGGG -> ACGCGCCGGGT
GACGTAGTGTC -> ACGTAGTGTCG
GACGTGAAAGC -> ACGTGAAAGCT
GACGTGATTAT -> ACGTGATTATC
GACGTGTGCTC -> ACGTGTGCTCA
GACTAACATAT -> ACTAACATATG
GACTAACGTTA -> ACTAACGTTAT
GACTATGATTT -> ACTATGATTTA
GACTCAGAAAG -> ACTCAGAAAGC
GACTCGTTCAT -> ACTCGTTCATA
GACTGAAATCT -> ACTGAAATCTT
GACTGCGAGAC -> ACTGCGAGACC
GACTGTGGCTG -> ACTGTGGCTGC
GACTTCGCACG -> ACTTCGCACGA
GACTTCTACGT -> ACTTCTACGTT
GACTTGTCCCT -> ACTTGTCCCTT
GACTTTGGACG -> ACTTTGGACGA
GAGAAGAGCTC -> AGAAGAGCTCC
GAGAATTGTAA -> AGAATTGTAAG
GAGACCGATGA -> AGACCGATGAG
GAGACGCGCCG -> AGACGCGCCGG
GAGAGATGGTA -> AGAGATGGTAT
GAGAGTCTATC -> AGAGTCTATCA
GAGATCGAATT -> AGATCGAATTC
GAGATGGTATT -> AGATGGTATTA
GAGATTTAACA -> AGATTTAACAG
GAGCAAGGCTG -> AGCAAGGCTGG
GAGCATTATAT -> AGCATTATATC
GAGCGGACTAA -> AGCGGACTAAC
GAGCGTACTGC -> AGCGTACTGCA
GAGCGTTCGTC -> AGCGTTCGTCG
GAGCTCCGTGT -> AGCTCCGTGTT
GAGCTTATGTC -> AGCTTATGTCG
GAGGAAGAACA -> AGGAAGAACAA
GAGGAAGGAGA -> AGGAAGGAGAC
GAGGACACTCT -> AGGACACTCTA
GAGGATTTCAT -> AGGATTTCATT
GAGGCCTGACT -> AGGCCTGACTA
GAGGGATAACT -> AGGGATAACTG
GAGGGATATTA -> AGGGATATTAT
GAGGGGCGGTG -> AGGGGCGGTGA
GAGGGGTGGGT -> AGGGGTGGGTT
GAGGTATAGCA -> AGGTATAGCAT
GAGGTGTTGAC -> AGGTGTTGACC
GAGTAAACGCC -> AGTAAACGCCG
GAGTCTATCAT -> AGTCTATCATC
GAGTGACAAAC -> AGTGACAAACG
GAGTTCCACTT -> AGTTCCACTTA
GAGTTGTATTT -> AGTTGTATTTA
GATAACACGGT -> ATAACACGGTA
GATAACTGCCC -> ATAACTGCCCC
GATACAAATGA -> ATACAAATGAT
GATACACTAAA -> ATACACTAAAG
GATACTAGGGT -> ATACTAGGGTG
GATATACATTC -> ATATACATTCA
GATATCCAAGG -> ATATCCAAGGA
GATATTATAAC -> ATATTATAACA
GATCACGTCAA -> ATCACGTCAAC
GATCAGATTAT -> ATCAGATTATG
GATCCATTTTA -> ATCCATTTTAT
GATCCGATATC -> ATCCGATATCC
GATCGAATTCG -> ATCGAATTCGA
GATCGCCAGGC -> ATCGCCAGGCT
GATCTCCAGCT -> ATCTCCAGCTG
GATCTGTTTAA -> ATCTGTTTAAA
GATGAGCGTAC -> ATGAGCGTACT
GATGAGTTGTA -> ATGAGTTGTAT
GATGCACAGAT -> ATGCACAGATG
GATGCCGAAAG -> ATGCCGAAAGG
GATGCCTCGAT -> ATGCCTCGATG
GATGCGAGGAA -> ATGCGAGGAAG
GATGGGTAGTA -> ATGGGTAGTAG
GATGGTATTAC -> ATGGTATTACA
GATGGTTAGGT -> ATGGTTAGGTC
GATGTAGCCGT -> ATGTAGCCGTT
GATGTATAGCA -> ATGTATAGCAC
GATGTGGCAGT -> ATGTGGCAGTC
GATGTTGTCCG -> ATGTTGTCCGA
GATTAATAGAG -> ATTAATAGAGG
GATTAGCCCTG -> ATTAGCCCTGA
GATTATCTCCC -> ATTATCTCCCC
GATTATGGTGG -> ATTATGGTGGT
GATTCGAGGAC -> ATTCGAGGACA
GATTCGATACT -> ATTCGATACTA
GATTTAACAGG -> ATTTAACAGGC
GATTTACGTTA -> ATTTACGTTAA
GATTTATCGAC -> ATTTATCGACT
GATTTCATTAT -> ATTTCATTATA
GATTTTTCTTG -> ATTTTTCTTGG
GCAAAGGTTGT -> CAAAGGTTGTG
GCAACCGATCT -> CAACCGATCTC
GCAACGACTTC -> CAACGACTTCG
GCAACGGTGAC -> CAACGGTGACA
GCAAGGCTGGG -> CAAGGCTGGGT
GCACAAGGGTT -> CACAAGGGTTC
GCACACGACGT -> CACACGACGTA
GCACAGATGCC -> CACAGATGCCT
GCACCACGCGA -> CACCACGCGAA
GCACCATGCAC -> CACCATGCACT
GCACGATACAC -> CACGATACACT
GCACGGGGCTC -> CACGGGGCTCT
GCACTACGTCA -> CACTACGTCAT
GCACTTCCCCG -> CACTTCCCCGA
GCAGAGCAAGG -> CAGAGCAAGGC
GCAGCGAGGTA -> CAGCGAGGTAT
GCAGCTATACC -> CAGCTATACCA
GCAGGCGCATC -> CAGGCGCATCG
GCAGGGCAACG -> CAGGGCAACGA
GCAGTAATATG -> CAGTAATATGT
GCAGTCAAGAA -> CAGTCAAGAAT
GCAGTCGCTGG -> CAGTCGCTGGG
GCAGTGCACAA -> CAGTGCACAAG
GCAGTTAATGG -> CAGTTAATGGA
GCAGTTCTCAT -> CAGTTCTCATC
GCATAAATTCG -> CATAAATTCGC
GCATAGACTGT -> CATAGACTGTG
GCATAGCGTCC -> CATAGCGTCCT
GCATAGTATAA -> CATAGTATAAG
GCATCATGTTC -> CATCATGTTCG
GCATCGGGGTT -> CATCGGGGTTC
GCATCTTCTAC -> CATCTTCTACA
GCATTATATCT -> CATTATATCTG
GCCAACTCCAC -> CCAACTCCACC
GCCACCGTGAT -> CCACCGTGATA
GCCACCTGAGT -> CCACCTGAGTG
GCCACTACTTT -> CCACTACTTTG
GCCACTATTCT -> CCACTATTCTT
GCCACTTCACG -> CCACTTCACGA
GCCAGGAGGGA -> CCAGGAGGGAT
GCCAGGCTCTT -> CCAGGCTCTTA
GCCATGGCATA -> CCATGGCATAG
GCCCAATCGGT -> CCCAATCGGTT
GCCCCCTAGAT -> CCCCCTAGATT
GCCCGCAGTTC -> CCCGCAGTTCT
GCCCGTGCTCA -> CCCGTGCTCAA
GCCCTGACACG -> CCCTGACACGT
GCCGAAAGGAC -> CCGAAAGGACT
GCCGATTCGAG -> CCGATTCGAGG
GCCGCATCTTC -> CCGCATCTTCT
GCCGGATTCGA -> CCGGATTCGAT
GCCGGCCGTTC -> CCGGCCGTTCA
GCCGGGTGGGC -> CCGGGTGGGCT
GCCGGGTTCGA -> CCGGGTTCGAA
GCCGTCATGCT -> CCGTCATGCTC
GCCGTTCAACG -> CCGTTCAACGA
GCCGTTGTGTA -> CCGTTGTGTAC
GCCTCGATGAG -> CCTCGATGAGC
GCCTGACTATG -> CCTGACTATGA
GCCTTTCAGCC -> CCTTTCAGCCA
GCGAAGGACGT -> CGAAGGACGTG
GCGACATAACA -> CGACATAACAA
GCGACCGTGGT -> CGACCGTGGTT
GCGACGACCAG -> CGACGACCAGG
GCGAGACCGAT -> CGAGACCGATG
GCGAGGAAGAA -> CGAGGAAGAAC
GCGAGGTATAG -> CGAGGTATAGC
GCGCATCATGT -> CGCATCATGTT
GCGCATCGGGG -> CGCATCGGGGT
GCGCCCGTGCT -> CGCCCGTGCTC
GCGCCGGGTTC -> CGCCGGGTTCG
GCGCGCCCGTG -> CGCGCCCGTGC
GCGCGGTACAG -> CGCGGTACAGG
GCGCTTAAAGA -> CGCTTAAAGAT
GCGGACTAACA -> CGGACTAACAT
GCGGTACAGGC -> CGGTACAGGCC
GCGGTAGCAGC -> CGGTAGCAGCG
GCGGTGAACTG -> CGGTGAACTGA
GCGTACTGCAG -> CGTACTGCAGC
GCGTCCTAAAG -> CGTCCTAAAGC
GCGTTCGTCGA -> CGTTCGTCGAT
GCTACAGGCAC -> CTACAGGCACA
GCTACGCAGGC -> CTACGCAGGCG
GCTACTGAATG -> CTACTGAATGT
GCTAGAATGAC -> CTAGAATGACT
GCTAGATGTAG -> CTAGATGTAGC
GCTAGGATGCC -> CTAGGATGCCG
GCTAGTCTGGA -> CTAGTCTGGAG
GCTATACCACC -> CTATACCACCC
GCTCAACAACT -> CTCAACAACTT
GCTCAAGGTTT -> CTCAAGGTTTT
GCTCAATGCAC -> CTCAATGCACC
GCTCCGTGTTG -> CTCCGTGTTGT
GCTCTACGTTA -> CTCTACGTTAG
GCTCTAGTTCT -> CTCTAGTTCTA
GCTCTCATTAG -> CTCTCATTAGG
GCTCTGACTAA -> CTCTGACTAAC
GCTCTTAACAG -> CTCTTAACAGC
GCTCTTCACGA -> CTCTTCACGAG
GCTGAATGCCA -> CTGAATGCCAC
GCTGAGGAAGG -> CTGAGGAAGGA
GCTGCCACTAC -> CTGCCACTACT
GCTGCTAGTCT -> CTGCTAGTCTG
GCTGCTGCTAG -> CTGCTGCTAGT
GCTGGGCTTTG -> CTGGGCTTTGT
GCTGGGTAAAC -> CTGGGTAAACT
GCTTAAACGGT -> CTTAAACGGTT
GCTTAAAGATC -> CTTAAAGATCC
GCTTATAGTTA -> CTTATAGTTAT
GCTTATGTCGA -> CTTATGTCGAT
GCTTTATTAAA -> CTTTATTAAAT
GCTTTGTTGTC -> CTTTGTTGTCT
GGAAAGTCGAG -> GAAAGTCGAGG
GGAAGAACAAA -> GAAGAACAAAG
GGAAGGAGACG -> GAAGGAGACGC
GGACACTCTAT -> GACACTCTATT
GGACCACTTAC -> GACCACTTACG
GGACCCATAAC -> GACCCATAACT
GGACCGTGAGA -> GACCGTGAGAG
GGACGAGCTTA -> GACGAGCTTAT
GGACGTGTGCT -> GACGTGTGCTC
GGACTAACATA -> GACTAACATAT
GGACTCAGAAA -> GACTCAGAAAG
GGAGACGCGCC -> GAGACGCGCCG
GGAGCGGACTA -> GAGCGGACTAA
GGAGCGTTCGT -> GAGCGTTCGTC
GGAGGGATAAC -> GAGGGATAACT
GGAGTAAACGC -> GAGTAAACGCC
GGATAACACGG -> GATAACACGGT
GGATAACTGCC -> GATAACTGCCC
GGATACAAATG -> GATACAAATGA
GGATATTATAA -> GATATTATAAC
GGATCGCCAGG -> GATCGCCAGGC
GGATGCCGAAA -> GATGCCGAAAG
GGATGGGTAGT -> GATGGGTAGTA
GGATGTATAGC -> GATGTATAGCA
GGATTCGATAC -> GATTCGATACT
GGATTTCATTA -> GATTTCATTAT
GGATTTTTCTT -> GATTTTTCTTG
GGCAAAGGTTG -> GCAAAGGTTGT
GGCAACGACTT -> GCAACGACTTC
GGCACACGACG -> GCACACGACGT
GGCACTTCCCC -> GCACTTCCCCG
GGCAGAGCAAG -> GCAGAGCAAGG
GGCAGTCAAGA -> GCAGTCAAGAA
GGCAGTCGCTG -> GCAGTCGCTGG
GGCAGTTAATG -> GCAGTTAATGG
GGCATAGTATA -> GCATAGTATAA
GGCCAGGAGGG -> GCCAGGAGGGA
GGCCCGCAGTT -> GCCCGCAGTTC
GGCCGATTCGA -> GCCGATTCGAG
GGCCGTTCAAC -> GCCGTTCAACG
GGCCTGACTAT -> GCCTGACTATG
GGCGACCGTGG -> GCGACCGTGGT
GGCGCATCGGG -> GCGCATCGGGG
GGCGGTGAACT -> GCGGTGAACTG
GGCTACAGGCA -> GCTACAGGCAC
GGCTACTGAAT -> GCTACTGAATG
GGCTAGAATGA -> GCTAGAATGAC
GGCTCTCATTA -> GCTCTCATTAG
GGCTCTTAACA -> GCTCTTAACAG
GGCTGCTGCTA -> GCTGCTGCTAG
GGCTGGGTAAA -> GCTGGGTAAAC
GGCTTTGTTGT -> GCTTTGTTGTC
GGGATAACACG -> GGATAACACGG
GGGATAACTGC -> GGATAACTGCC
GGGATACAAAT -> GGATACAAATG
GGGATATTATA -> GGATATTATAA
GGGATGGGTAG -> GGATGGGTAGT
GGGCAACGACT -> GGCAACGACTT
GGGCAGAGCAA -> GGCAGAGCAAG
GGGCAGTTAAT -> GGCAGTTAATG
GGGCCCGCAGT -> GGCCCGCAGTT
GGGCGGTGAAC -> GGCGGTGAACT
GGGCTACTGAA -> GGCTACTGAAT
GGGCTAGAATG -> GGCTAGAATGA
GGGCTCTCATT -> GGCTCTCATTA
GGGCTTTGTTG -> GGCTTTGTTGT
GGGGCGGTGAA -> GGGCGGTGAAC
GGGGCTACTGA -> GGGCTACTGAA
GGGGCTCTCAT -> GGGCTCTCATT
GGGGTGGGTTG -> GGGTGGGTTGG
GGGGTTCAACA -> GGGTTCAACAT
GGGTAAACTTC -> GGTAAACTTCT
GGGTAGAGCAT -> GGTAGAGCATT
GGGTAGTAGAA -> GGTAGTAGAAG
GGGTGCCATGG -> GGTGCCATGGC
GGGTGGGCTAG -> GGTGGGCTAGA
GGGTGGGTTGG -> GGTGGGTTGGT
GGGTTCAACAT -> GGTTCAACATA,GGTTCAACATC
GGGTTCGAACC -> GGTTCGAACCA
GGGTTGGTGCG -> GGTTGGTGCGC
GGTAAACTTCT -> GTAAACTTCTA
GGTAACCAATT -> GTAACCAATTA
GGTACAGGCCG -> GTACAGGCCGA
GGTACCAAGCT -> GTACCAAGCTG
GGTACCTGGAC -> GTACCTGGACC
GGTAGAGCATT -> GTAGAGCATTA
GGTAGCAGCGA -> GTAGCAGCGAG
GGTAGTAGAAG -> GTAGTAGAAGA
GGTATAACGCT -> GTATAACGCTT
GGTATAGCATA -> GTATAGCATAG
GGTATTACACA -> GTATTACACAG
GGTCAGAAACT -> GTCAGAAACTG
GGTCAGAGATC -> GTCAGAGATCG
GGTCCCCTGTG -> GTCCCCTGTGC
GGTCTCTCCTC -> GTCTCTCCTCG
GGTGAACTGAG -> GTGAACTGAGG
GGTGACAAAGA -> GTGACAAAGAA
GGTGCCATGGC -> GTGCCATGGCA
GGTGCGCTTAA -> GTGCGCTTAAA
GGTGGATCGCC -> GTGGATCGCCA
GGTGGGACTAG -> GTGGGACTAGT
GGTGGGCTAGA -> GTGGGCTAGAA
GGTGGGTTGGT -> GTGGGTTGGTG
GGTGGTACCTG -> GTGGTACCTGG
GGTGTGTTAAC -> GTGTGTTAACG
GGTGTTGACCC -> GTGTTGACCCG
GGTTAGCTCTA -> GTTAGCTCTAC
GGTTAGGTCTC -> GTTAGGTCTCT
GGTTATAGCCG -> GTTATAGCCGG
GGTTCAACATA -> GTTCAACATAC
GGTTCAACATC -> GTTCAACATCT
GGTTCGAACCA -> GTTCGAACCAA
GGTTGCCACTT -> GTTGCCACTTC
GGTTGGTGCGC -> GTTGGTGCGCT
GGTTGTGACCA -> GTTGTGACCAT
GGTTTTGCAAC -> GTTTTGCAACC
GTAAACGCCGG -> TAAACGCCGGC
GTAAACTTCTA -> TAAACTTCTAG
GTAACCAATTA -> TAACCAATTAC
GTAAGTATACC -> TAAGTATACCC
GTAATATGTTG -> TAATATGTTGC
GTAATCCCTAA -> TAATCCCTAAC
GTACAAGATTT -> TACAAGATTTA
GTACAGGCCGA -> TACAGGCCGAT
GTACCAAGCTG -> TACCAAGCTGA
GTACCTGGACC -> TACCTGGACCC
GTACTACCTTT -> TACTACCTTTA
GTACTGCAGCT -> TACTGCAGCTA
GTAGAAGACTG -> TAGAAGACTGA
GTAGAGCATTA -> TAGAGCATTAT
GTAGCAGCGAG -> TAGCAGCGAGG
GTAGCCGTTGT -> TAGCCGTTGTG
GTAGGTCCCCT -> TAGGTCCCCTG
GTAGTAGAAGA -> TAGTAGAAGAC
GTAGTGTCGAG -> TAGTGTCGAGG
GTATAACGCTT -> TATAACGCTTA
GTATAAGACGC -> TATAAGACGCC
GTATACCCCGC -> TATACCCCGCC
GTATAGCACCA -> TATAGCACCAC
GTATAGCATAG -> TATAGCATAGC
GTATTACACAG -> TATTACACAGT
GTATTTAGACC -> TATTTAGACCT
GTCAACACGGT -> TCAACACGGTC
GTCAAGAATGA -> TCAAGAATGAC
GTCAGAAACTG -> TCAGAAACTGT
GTCAGAGATCG -> TCAGAGATCGA
GTCATGCTCTA -> TCATGCTCTAG
GTCATTAGTCT -> TCATTAGTCTC
GTCCCCTGTGC -> TCCCCTGTGCG
GTCCCTTCGAT -> TCCCTTCGATT
GTCCGACAGCA -> TCCGACAGCAA
GTCCGATGTTG -> TCCGATGTTGT
GTCCTAAAGCT -> TCCTAAAGCTA
GTCGAACTCGT -> TCGAACTCGTA
GTCGAGGGGCG -> TCGAGGGGCGG
GTCGAGGTGTT -> TCGAGGTGTTG
GTCGATCCATT -> TCGATCCATTT
GTCGATGTGGC -> TCGATGTGGCA
GTCGCTGGGCT -> TCGCTGGGCTT
GTCGGTGTGTT -> TCGGTGTGTTA
GTCTATCATCG -> TCTATCATCGT
GTCTCTCCTCG -> TCTCTCCTCGC
GTCTCTGATGC -> TCTCTGATGCA
GTCTGGAGCGG -> TCTGGAGCGGA
GTCTGGATTTT -> TCTGGATTTTT
GTCTGGGATAA -> TCTGGGATAAC
GTGAAAGCTCT -> TGAAAGCTCTT
GTGAACTGAGG -> TGAACTGAGGC
GTGAAGCTCAA -> TGAAGCTCAAG
GTGACAAACGG -> TGACAAACGGT
GTGACAAAGAA -> TGACAAAGAAG
GTGACCATATG -> TGACCATATGC
GTGAGAAGAGC -> TGAGAAGAGCT
GTGAGAGTCTA -> TGAGAGTCTAT
GTGAGTTCCAC -> TGAGTTCCACT
GTGATATACAT -> TGATATACATT
GTGATTATCTC -> TGATTATCTCC
GTGCACAAGGG -> TGCACAAGGGT
GTGCCATGGCA -> TGCCATGGCAT
GTGCGACGACC -> TGCGACGACCA
GTGCGCGGTAC -> TGCGCGGTACA
GTGCGCTTAAA -> TGCGCTTAAAG
GTGCTCAACAA -> TGCTCAACAAC
GTGCTCAATGC -> TGCTCAATGCA
GTGGATCGCCA -> TGGATCGCCAG
GTGGCAAAGGT -> TGGCAAAGGTT
GTGGCAGTCAA -> TGGCAGTCAAG
GTGGCTGCTGC -> TGGCTGCTGCT
GTGGGACTAGT -> TGGGACTAGTA
GTGGGCTAGAA -> TGGGCTAGAAT
GTGGGTTGGTG -> TGGGTTGGTGC
GTGGTACCTGG -> TGGTACCTGGA
GTGGTTAGCTC -> TGGTTAGCTCT
GTGTACAAGAT -> TGTACAAGATT
GTGTCGAGGGG -> TGTCGAGGGGC
GTGTCGGTGTG -> TGTCGGTGTGT
GTGTGCTCAAT -> TGTGCTCAATG
GTGTGTTAACG -> TGTGTTAACGT
GTGTTAACGTC -> TGTTAACGTCC
GTGTTGACCCG -> TGTTGACCCGC
GTGTTGTACTA -> TGTTGTACTAC
GTTAACGTCCG -> TTAACGTCCGA
GTTAAGTGCGC -> TTAAGTGCGCG
GTTAATGGAAA -> TTAATGGAAAG
GTTAGCTCTAC -> TTAGCTCTACG
GTTAGGTCTCT -> TTAGGTCTCTC
GTTAGTGAGAA -> TTAGTGAGAAG
GTTATAGCCGG -> TTATAGCCGGG
GTTATCGGGGC -> TTATCGGGGCT
GTTATTCATCC -> TTATTCATCCT
GTTATTCGGTG -> TTATTCGGTGG
GTTCAACATAC -> TTCAACATACC
GTTCAACATCT -> TTCAACATCTC
GTTCAACGATG -> TTCAACGATGC
GTTCATATGAA -> TTCATATGAAT
GTTCCACTTAC -> TTCCACTTACC
GTTCCATAGCT -> TTCCATAGCTG
GTTCCTAAAAT -> TTCCTAAAATT
GTTCGAACCAA -> TTCGAACCAAG
GTTCGAACGGA -> TTCGAACGGAG
GTTCGGTAACC -> TTCGGTAACCA
GTTCGTCGATC -> TTCGTCGATCC
GTTCTACGACG -> TTCTACGACGT
GTTCTCATCGA -> TTCTCATCGAG
GTTGAAGTGTC -> TTGAAGTGTCG
GTTGACCCGCT -> TTGACCCGCTT
GTTGCCACTTC -> TTGCCACTTCA
GTTGCGCGCCC -> TTGCGCGCCCG
GTTGGGTAGAG -> TTGGGTAGAGC
GTTGGTGCGCT -> TTGGTGCGCTT
GTTGTACTACC -> TTGTACTACCT
GTTGTATTTAG -> TTGTATTTAGA
GTTGTCCGACA -> TTGTCCGACAG
GTTGTCTGGAT -> TTGTCTGGATT
GTTGTGACCAT -> TTGTGACCATA
GTTGTGTACAA -> TTGTGTACAAG
GTTTAAAGCCG -> TTTAAAGCCGT
GTTTGCAGTAA -> TTTGCAGTAAT
GTTTGTGAAGC -> TTTGTGAAGCT
GTTTTGCAACC -> TTTTGCAACCG
TAAAATTCTTT -> AAAATTCTTTT
TAAACGCCGGC -> AAACGCCGGCC
TAAACGGTTGC -> AAACGGTTGCC
TAAACTTCTAG -> AAACTTCTAGG
TAAAGAGGATT -> AAAGAGGATTT
TAAAGATCCGA -> AAAGATCCGAT
TAAAGCCGTCA -> AAAGCCGTCAT
TAAAGCTACGC -> AAAGCTACGCA
TAAATCCTGGA -> AAATCCTGGAT
TAAATGACATC -> AAATGACATCA
TAAATTCGCCA -> AAATTCGCCAA
TAACAACCAGA -> AACAACCAGAC
TAACACGAGAT -> AACACGAGATT
TAACACGGTAT -> AACACGGTATA
TAACAGCACGG -> AACAGCACGGG
TAACAGGCTAC -> AACAGGCTACA
TAACATATGCT -> AACATATGCTA
TAACCAATTAC -> AACCAATTACC
TAACGCTTAAA -> AACGCTTAAAC
TAACGTCCGAT -> AACGTCCGATG
TAACGTTATTC -> AACGTTATTCG
TAACGTTGAAG -> AACGTTGAAGT
TAACTCGGGCC -> AACTCGGGCCC
TAACTGCCCCC -> AACTGCCCCCT
TAAGACGCCAC -> AAGACGCCACC
TAAGTATACCC -> AAGTATACCCC
TAAGTGCGCGG -> AAGTGCGCGGT
TAATAGAGGGG -> AATAGAGGGGT
TAATATGTTGC -> AATATGTTGCG
TAATCCCTAAC -> AATCCCTAACG
TAATGGAAAGT -> AATGGAAAGTC
TACAAAGCTTT -> ACAAAGCTTTA
TACAAATGATC -> ACAAATGATCA
TACAAGATTTA -> ACAAGATTTAC
TACACAGTTTG -> ACACAGTTTGT
TACACTAAAGA -> ACACTAAAGAG
TACAGGCACAC -> ACAGGCACACG
TACAGGCCGAT -> ACAGGCCGATT
TACATTCAGCG -> ACATTCAGCGG
TACCAACATGG -> ACCAACATGGG
TACCAAGCTGA -> ACCAAGCTGAG
TACCACCCTGA -> ACCACCCTGAT
TACCATATAAA -> ACCATATAAAT
TACCCCGCCGC -> ACCCCGCCGCA
TACCCTCACGC -> ACCCTCACGCA
TACCTACTATG -> ACCTACTATGC
TACCTCATATC -> ACCTCATATCT
TACCTGGACCC -> ACCTGGACCCA
TACCTTTATCC -> ACCTTTATCCG
TACGAAGTGAG -> ACGAAGTGAGT
TACGACGTGAA -> ACGACGTGAAA
TACGCAGGCGC -> ACGCAGGCGCA
TACGTCATTAG -> ACGTCATTAGT
TACGTTAAGTG -> ACGTTAAGTGC
TACGTTAGTGA -> ACGTTAGTGAG
TACGTTATCGG -> ACGTTATCGGG
TACGTTCCTAA -> ACGTTCCTAAA
TACTACCTTTA -> ACTACCTTTAT
TACTAGGGTGC -> ACTAGGGTGCC
TACTATGCATA -> ACTATGCATAA
TACTCGTTTGC -> ACTCGTTTGCA
TACTGAATGTC -> ACTGAATGTCG
TACTGCAGCTA -> ACTGCAGCTAT
TACTTTGGGCA -> ACTTTGGGCAG
TAGAAGACTGA -> AGAAGACTGAA
TAGAATGACTG -> AGAATGACTGC
TAGACCTCCAT -> AGACCTCCATC
TAGACTGTGGC -> AGACTGTGGCT
TAGAGCATTAT -> AGAGCATTATA
TAGAGGGGTGG -> AGAGGGGTGGG
TAGATGTAGCC -> AGATGTAGCCG
TAGATTAGCCC -> AGATTAGCCCT
TAGCACCACGC -> AGCACCACGCG
TAGCAGCGAGG -> AGCAGCGAGGT
TAGCATAGCGT -> AGCATAGCGTC
TAGCCCTGACA -> AGCCCTGACAC
TAGCCGGGTGG -> AGCCGGGTGGG
TAGCCGTTGTG -> AGCCGTTGTGT
TAGCGTCCTAA -> AGCGTCCTAAA
TAGCTCTACGT -> AGCTCTACGTT
TAGCTGCCACT -> AGCTGCCACTA
TAGGATGCCGA -> AGGATGCCGAA
TAGGCGACCGT -> AGGCGACCGTG
TAGGGCAGAGC -> AGGGCAGAGCA
TAGGGTGCCAT -> AGGGTGCCATG
TAGGTCCCCTG -> AGGTCCCCTGT
TAGGTCTCTCC -> AGGTCTCTCCT
TAGTAGAAGAC -> AGTAGAAGACT
TAGTATAAGAC -> AGTATAAGACG
TAGTCTCTGAT -> AGTCTCTGATG
TAGTCTGGAGC -> AGTCTGGAGCG
TAGTGAGAAGA -> AGTGAGAAGAG
TAGTGGCAAAG -> AGTGGCAAAGG
TAGTGTCGAGG -> AGTGTCGAGGG
TAGTTATTCAT -> AGTTATTCATC
TAGTTCTACGA -> AGTTCTACGAC
TATAAATCCTG -> ATAAATCCTGG
TATAACACGAG -> ATAACACGAGA
TATAACGCTTA -> ATAACGCTTAA
TATAAGACGCC -> ATAAGACGCCA
TATACATTCAG -> ATACATTCAGC
TATACCAACAT -> ATACCAACATG
TATACCACCCT -> ATACCACCCTG
TATACCCCGCC -> ATACCCCGCCG
TATAGCACCAC -> ATAGCACCACG
TATAGCATAGC -> ATAGCATAGCG
TATAGCCGGGT -> ATAGCCGGGTG
TATAGTTATTC -> ATAGTTATTCA
TATATCTGGTG -> ATATCTGGTGG
TATCATCGTTG -> ATCATCGTTGG
TATCCAAGGAC -> ATCCAAGGACC
TATCCGGACCA -> ATCCGGACCAC
TATCGACTTCT -> ATCGACTTCTA
TATCGACTTTG -> ATCGACTTTGG
TATCGGGGCTA -> ATCGGGGCTAC
TATCTCCCCTG -> ATCTCCCCTGT
TATCTGGTGGA -> ATCTGGTGGAT
TATCTTTCAGG -> ATCTTTCAGGT
TATGAATCCAC -> ATGAATCCACC
TATGATTTATC -> ATGATTTATCG
TATGCATAAAT -> ATGCATAAATT
TATGCGCATCA -> ATGCGCATCAT
TATGCTAGATG -> ATGCTAGATGT
TATGGGATGGG -> ATGGGATGGGT
TATGGTGGTAC -> ATGGTGGTACC
TATGTCGATGT -> ATGTCGATGTG
TATGTTGCGCG -> ATGTTGCGCGC
TATTAAATGAC -> ATTAAATGACA
TATTACACAGT -> ATTACACAGTT
TATTACTCGTT -> ATTACTCGTTT
TATTATAACAC -> ATTATAACACG
TATTCATCCTA -> ATTCATCCTAC
TATTCGGTGGG -> ATTCGGTGGGA
TATTCTTATGG -> ATTCTTATGGG
TATTTAGACCT -> ATTTAGACCTC
TCAAAAACTTG -> CAAAAACTTGC
TCAACAACTTT -> CAACAACTTTG
TCAACACGGTC -> CAACACGGTCA
TCAACATACCA -> CAACATACCAT
TCAACATCTCA -> CAACATCTCAA
TCAACGATGCG -> CAACGATGCGA
TCAAGAATGAC -> CAAGAATGACC
TCAAGGTTTTG -> CAAGGTTTTGC
TCAATGCACCA -> CAATGCACCAT
TCACGAATGCG -> CACGAATGCGA
TCACGAGAATT -> CACGAGAATTG
TCACGCATAGA -> CACGCATAGAC
TCACGTCAACA -> CACGTCAACAC
TCAGAAACTGT -> CAGAAACTGTC
TCAGAAAGCCT -> CAGAAAGCCTT
TCAGACTCGTT -> CAGACTCGTTC
TCAGAGATCGA -> CAGAGATCGAA
TCAGATTATGG -> CAGATTATGGT
TCAGCCACTAT -> CAGCCACTATT
TCAGCGGTAGC -> CAGCGGTAGCA
TCAGGTACCAA -> CAGGTACCAAG
TCATATCTTTC -> CATATCTTTCA
TCATATGAATC -> CATATGAATCC
TCATCCTACCT -> CATCCTACCTC
TCATCGAGGGA -> CATCGAGGGAT
TCATCGTTGGG -> CATCGTTGGGT
TCATGCTCTAG -> CATGCTCTAGT
TCATGTTCGAA -> CATGTTCGAAC
TCATTAGGGCA -> CATTAGGGCAG
TCATTAGTCTC -> CATTAGTCTCT
TCATTATACCA -> CATTATACCAA
TCCAAGGACCG -> CCAAGGACCGT
TCCACCAAGTT -> CCACCAAGTTC
TCCACCGCTAG -> CCACCGCTAGG
TCCACTTACCT -> CCACTTACCTA
TCCAGCTGAAT -> CCAGCTGAATG
TCCATAGCTGC -> CCATAGCTGCC
TCCATCGATCA -> CCATCGATCAG
TCCATTTTATC -> CCATTTTATCG
TCCCCGATCTG -> CCCCGATCTGT
TCCCCTGTAGG -> CCCCTGTAGGT
TCCCCTGTGCG -> CCCCTGTGCGA
TCCCTAACGTT -> CCCTAACGTTG
TCCCTTCGATT -> CCCTTCGATTA
TCCGACAGCAA -> CCGACAGCAAC
TCCGATATCCA -> CCGATATCCAA
TCCGATGTTGT -> CCGATGTTGTC
TCCGGACCACT -> CCGGACCACTT
TCCGTGTTGTA -> CCGTGTTGTAC
TCCTAAAATTC -> CCTAAAATTCT
TCCTAAAGCTA -> CCTAAAGCTAC
TCCTACCTCAT -> CCTACCTCATA
TCCTCGCCGGA -> CCTCGCCGGAT
TCCTGGATGTA -> CCTGGATGTAT
TCGAACCAAGA -> CGAACCAAGAG
TCGAACCTACG -> CGAACCTACGT
TCGAACGGAGC -> CGAACGGAGCG
TCGAACTCGTA -> CGAACTCGTAA
TCGAATTCGAA -> CGAATTCGAAC
TCGACTTCTAC -> CGACTTCTACG
TCGACTTTGGA -> CGACTTTGGAC
TCGAGGACACT -> CGAGGACACTC
TCGAGGGATAT -> CGAGGGATATT
TCGAGGGGCGG -> CGAGGGGCGGT
TCGAGGTGTTG -> CGAGGTGTTGA
TCGATACTAGG -> CGATACTAGGG
TCGATCAGATT -> CGATCAGATTA
TCGATCCATTT -> CGATCCATTTT
TCGATGAGCGT -> CGATGAGCGTA
TCGATGTGGCA -> CGATGTGGCAG
TCGATTAATAG -> CGATTAATAGA
TCGCACGATAC -> CGCACGATACA
TCGCCAACTCC -> CGCCAACTCCA
TCGCCAGGCTC -> CGCCAGGCTCT
TCGCCGGATTC -> CGCCGGATTCG
TCGCTGGGCTT -> CGCTGGGCTTT
TCGGGCCCGCA -> CGGGCCCGCAG
TCGGGGCTACT -> CGGGGCTACTG
TCGGGGTTCAA -> CGGGGTTCAAC
TCGGTAACCAA -> CGGTAACCAAT
TCGGTGGGACT -> CGGTGGGACTA
TCGGTGTGTTA -> CGGTGTGTTAA
TCGGTTATAGC -> CGGTTATAGCC
TCGTAATCCCT -> CGTAATCCCTA
TCGTCGATCCA -> CGTCGATCCAT
TCGTTCATATG -> CGTTCATATGA
TCGTTGGGTAG -> CGTTGGGTAGA
TCGTTTGCAGT -> CGTTTGCAGTA
TCTACAAAGCT -> CTACAAAGCTT
TCTACGACGTG -> CTACGACGTGA
TCTACGTTAGT -> CTACGTTAGTG
TCTACGTTATC -> CTACGTTATCG
TCTAGGCGACC -> CTAGGCGACCG
TCTAGTTCTAC -> CTAGTTCTACG
TCTATCATCGT -> CTATCATCGTT
TCTATTACTCG -> CTATTACTCGT
TCTCAAAAACT -> CTCAAAAACTT
TCTCATCGAGG -> CTCATCGAGGG
TCTCATTAGGG -> CTCATTAGGGC
TCTCCAGCTGA -> CTCCAGCTGAA
TCTCCCCTGTA -> CTCCCCTGTAG
TCTCCTCGCCG -> CTCCTCGCCGG
TCTCTCCTCGC -> CTCTCCTCGCC
TCTCTGATGCA -> CTCTGATGCAC
TCTGACTAACG -> CTGACTAACGT
TCTGATGCACA -> CTGATGCACAG
TCTGGAGCGGA -> CTGGAGCGGAC
TCTGGATTTTT -> CTGGATTTTTC
TCTGGGATAAC -> CTGGGATAACA
TCTGGTGGATC -> CTGGTGGATCG
TCTGTTTAAAG -> CTGTTTAAAGC
TCTTAACAGCA -> CTTAACAGCAC
TCTTATGGGAT -> CTTATGGGATG
TCTTCACGAGA -> CTTCACGAGAA
TCTTCTACAAA -> CTTCTACAAAG
TCTTCTTGCAG -> CTTCTTGCAGG
TCTTGCAGGGC -> CTTGCAGGGCA
TCTTGGCACTT -> CTTGGCACTTC
TCTTTCAGGTA -> CTTTCAGGTAC
TCTTTTTTGGA -> CTTTTTTGGAG
TGAAAGCTCTT -> GAAAGCTCTTC
TGAAATCTTCT -> GAAATCTTCTT
TGAACTGAGGC -> GAACTGAGGCC
TGAAGCTCAAG -> GAAGCTCAAGG
TGAAGTGTCGG -> GAAGTGTCGGT
TGAATCCACCG -> GAATCCACCGC
TGAATGCCACC -> GAATGCCACCG
TGAATGTCGAA -> GAATGTCGAAC
TGACAAACGGT -> GACAAACGGTC
TGACAAAGAAG -> GACAAAGAAGC
TGACACGTTCC -> GACACGTTCCA
TGACATCAGAC -> GACATCAGACT
TGACCATATGC -> GACCATATGCG
TGACCCGCTTA -> GACCCGCTTAT
TGACCGACTTG -> GACCGACTTGT
TGACTAACGTT -> GACTAACGTTA
TGACTATGATT -> GACTATGATTT
TGACTGCGAGA -> GACTGCGAGAC
TGAGAAGAGCT -> GAGAAGAGCTC
TGAGAGTCTAT -> GAGAGTCTATC
TGAGCGTACTG -> GAGCGTACTGC
TGAGGAAGGAG -> GAGGAAGGAGA
TGAGGCCTGAC -> GAGGCCTGACT
TGAGTGACAAA -> GAGTGACAAAC
TGAGTTCCACT -> GAGTTCCACTT
TGAGTTGTATT -> GAGTTGTATTT
TGATATACATT -> GATATACATTC
TGATCACGTCA -> GATCACGTCAA
TGATGCACAGA -> GATGCACAGAT
TGATGGTTAGG -> GATGGTTAGGT
TGATTATCTCC -> GATTATCTCCC
TGATTTATCGA -> GATTTATCGAC
TGCAACCGATC -> GCAACCGATCT
TGCACAAGGGT -> GCACAAGGGTT
TGCACAGATGC -> GCACAGATGCC
TGCACCATGCA -> GCACCATGCAC
TGCACTACGTC -> GCACTACGTCA
TGCAGCTATAC -> GCAGCTATACC
TGCAGGGCAAC -> GCAGGGCAACG
TGCAGTAATAT -> GCAGTAATATG
TGCATAAATTC -> GCATAAATTCG
TGCCACCGTGA -> GCCACCGTGAT
TGCCACTACTT -> GCCACTACTTT
TGCCACTTCAC -> GCCACTTCACG
TGCCATGGCAT -> GCCATGGCATA
TGCCCAATCGG -> GCCCAATCGGT
TGCCCCCTAGA -> GCCCCCTAGAT
TGCCGAAAGGA -> GCCGAAAGGAC
TGCCTCGATGA -> GCCTCGATGAG
TGCGACATAAC -> GCGACATAACA
TGCGACGACCA -> GCGACGACCAG
TGCGAGACCGA -> GCGAGACCGAT
TGCGAGGAAGA -> GCGAGGAAGAA
TGCGCATCATG -> GCGCATCATGT
TGCGCGCCCGT -> GCGCGCCCGTG
TGCGCGGTACA -> GCGCGGTACAG
TGCGCTTAAAG -> GCGCTTAAAGA
TGCTAGATGTA -> GCTAGATGTAG
TGCTAGTCTGG -> GCTAGTCTGGA
TGCTCAACAAC -> GCTCAACAACT
TGCTCAATGCA -> GCTCAATGCAC
TGCTCTAGTTC -> GCTCTAGTTCT
TGCTGCTAGTC -> GCTGCTAGTCT
TGGAAAGTCGA -> GGAAAGTCGAG
TGGACCCATAA -> GGACCCATAAC
TGGACGAGCTT -> GGACGAGCTTA
TGGAGCGGACT -> GGAGCGGACTA
TGGAGTAAACG -> GGAGTAAACGC
TGGATCGCCAG -> GGATCGCCAGG
TGGATGTATAG -> GGATGTATAGC
TGGATTTTTCT -> GGATTTTTCTT
TGGCAAAGGTT -> GGCAAAGGTTG
TGGCACTTCCC -> GGCACTTCCCC
TGGCAGTCAAG -> GGCAGTCAAGA
TGGCAGTCGCT -> GGCAGTCGCTG
TGGCATAGTAT -> GGCATAGTATA
TGGCTGCTGCT -> GGCTGCTGCTA
TGGGATAACAC -> GGGATAACACG
TGGGATACAAA -> GGGATACAAAT
TGGGATGGGTA -> GGGATGGGTAG
TGGGCAGTTAA -> GGGCAGTTAAT
TGGGCTAGAAT -> GGGCTAGAATG
TGGGCTTTGTT -> GGGCTTTGTTG
TGGGTAAACTT -> GGGTAAACTTC
TGGGTAGAGCA -> GGGTAGAGCAT
TGGGTAGTAGA -> GGGTAGTAGAA
TGGGTTGGTGC -> GGGTTGGTGCG
TGGTACCTGGA -> GGTACCTGGAC
TGGTATTACAC -> GGTATTACACA
TGGTGCGCTTA -> GGTGCGCTTAA
TGGTGGATCGC -> GGTGGATCGCC
TGGTGGTACCT -> GGTGGTACCTG
TGGTTAGCTCT -> GGTTAGCTCTA
TGGTTAGGTCT -> GGTTAGGTCTC
TGTAAGTATAC -> GTAAGTATACC
TGTACAAGATT -> GTACAAGATTT
TGTACTACCTT -> GTACTACCTTT
TGTAGCCGTTG -> GTAGCCGTTGT
TGTAGGTCCCC -> GTAGGTCCCCT
TGTATAGCACC -> GTATAGCACCA
TGTATTTAGAC -> GTATTTAGACC
TGTCCCTTCGA -> GTCCCTTCGAT
TGTCCGACAGC -> GTCCGACAGCA
TGTCGAACTCG -> GTCGAACTCGT
TGTCGAGGGGC -> GTCGAGGGGCG
TGTCGATGTGG -> GTCGATGTGGC
TGTCGGTGTGT -> GTCGGTGTGTT
TGTCTGGATTT -> GTCTGGATTTT
TGTCTGGGATA -> GTCTGGGATAA
TGTGAAGCTCA -> GTGAAGCTCAA
TGTGACCATAT -> GTGACCATATG
TGTGCGACGAC -> GTGCGACGACC
TGTGCTCAATG -> GTGCTCAATGC
TGTGGCAGTCA -> GTGGCAGTCAA
TGTGGCTGCTG -> GTGGCTGCTGC
TGTGTACAAGA -> GTGTACAAGAT
TGTGTTAACGT -> GTGTTAACGTC
TGTTAACGTCC -> GTTAACGTCCG
TGTTCGAACGG -> GTTCGAACGGA
TGTTGACCCGC -> GTTGACCCGCT
TGTTGCGCGCC -> GTTGCGCGCCC
TGTTGTACTAC -> GTTGTACTACC
TGTTGTCCGAC -> GTTGTCCGACA
TGTTGTCTGGA -> GTTGTCTGGAT
TGTTTAAAGCC -> GTTTAAAGCCG
TTAAACGGTTG -> TAAACGGTTGC
TTAAAGATCCG -> TAAAGATCCGA
TTAAAGCCGTC -> TAAAGCCGTCA
TTAAATGACAT -> TAAATGACATC
TTAACAGCACG -> TAACAGCACGG
TTAACAGGCTA -> TAACAGGCTAC
TTAACGTCCGA -> TAACGTCCGAT
TTAAGTGCGCG -> TAAGTGCGCGG
TTAATAGAGGG -> TAATAGAGGGG
TTAATGGAAAG -> TAATGGAAAGT
TTACACAGTTT -> TACACAGTTTG
TTACCCTCACG -> TACCCTCACGC
TTACCTACTAT -> TACCTACTATG
TTACGAAGTGA -> TACGAAGTGAG
TTACGTTAAGT -> TACGTTAAGTG
TTACTCGTTTG -> TACTCGTTTGC
TTAGACCTCCA -> TAGACCTCCAT
TTAGCCCTGAC -> TAGCCCTGACA
TTAGCTCTACG -> TAGCTCTACGT
TTAGGGCAGAG -> TAGGGCAGAGC
TTAGGTCTCTC -> TAGGTCTCTCC
TTAGTCTCTGA -> TAGTCTCTGAT
TTAGTGAGAAG -> TAGTGAGAAGA
TTATAACACGA -> TATAACACGAG
TTATACCAACA -> TATACCAACAT
TTATAGCCGGG -> TATAGCCGGGT
TTATAGTTATT -> TATAGTTATTC
TTATATCTGGT -> TATATCTGGTG
TTATCCGGACC -> TATCCGGACCA
TTATCGACTTC -> TATCGACTTCT
TTATCGACTTT -> TATCGACTTTG
TTATCGGGGCT -> TATCGGGGCTA
TTATCTCCCCT -> TATCTCCCCTG
TTATGGGATGG -> TATGGGATGGG
TTATGGTGGTA -> TATGGTGGTAC
TTATGTCGATG -> TATGTCGATGT
TTATTAAATGA -> TATTAAATGAC
TTATTCATCCT -> TATTCATCCTA
TTATTCGGTGG -> TATTCGGTGGG
TTCAACATACC -> TCAACATACCA
TTCAACATCTC -> TCAACATCTCA
TTCAACGATGC -> TCAACGATGCG
TTCACGAATGC -> TCACGAATGCG
TTCACGAGAAT -> TCACGAGAATT
TTCAGCCACTA -> TCAGCCACTAT
TTCAGCGGTAG -> TCAGCGGTAGC
TTCAGGTACCA -> TCAGGTACCAA
TTCATATGAAT -> TCATATGAATC
TTCATCCTACC -> TCATCCTACCT
TTCATTATACC -> TCATTATACCA
TTCCACTTACC -> TCCACTTACCT
TTCCATAGCTG -> TCCATAGCTGC
TTCCCCGATCT -> TCCCCGATCTG
TTCCTAAAATT -> TCCTAAAATTC
TTCGAACCAAG -> TCGAACCAAGA
TTCGAACCTAC -> TCGAACCTACG
TTCGAACGGAG -> TCGAACGGAGC
TTCGAGGACAC -> TCGAGGACACT
TTCGATACTAG -> TCGATACTAGG
TTCGATTAATA -> TCGATTAATAG
TTCGCACGATA -> TCGCACGATAC
TTCGCCAACTC -> TCGCCAACTCC
TTCGGTAACCA -> TCGGTAACCAA
TTCGGTGGGAC -> TCGGTGGGACT
TTCGTCGATCC -> TCGTCGATCCA
TTCTACAAAGC -> TCTACAAAGCT
TTCTACGACGT -> TCTACGACGTG
TTCTACGTTAT -> TCTACGTTATC
TTCTAGGCGAC -> TCTAGGCGACC
TTCTCATCGAG -> TCTCATCGAGG
TTCTTATGGGA -> TCTTATGGGAT
TTCTTGCAGGG -> TCTTGCAGGGC
TTCTTGGCACT -> TCTTGGCACTT
TTCTTTTTTGG -> TCTTTTTTGGA
TTGAAGTGTCG -> TGAAGTGTCGG
TTGACCCGCTT -> TGACCCGCTTA
TTGCAACCGAT -> TGCAACCGATC
TTGCAGGGCAA -> TGCAGGGCAAC
TTGCAGTAATA -> TGCAGTAATAT
TTGCCACTTCA -> TGCCACTTCAC
TTGCCCAATCG -> TGCCCAATCGG
TTGCGCGCCCG -> TGCGCGCCCGT
TTGGACGAGCT -> TGGACGAGCTT
TTGGAGTAAAC -> TGGAGTAAACG
TTGGCACTTCC -> TGGCACTTCCC
TTGGCAGTCGC -> TGGCAGTCGCT
TTGGGCAGTTA -> TGGGCAGTTAA
TTGGGTAGAGC -> TGGGTAGAGCA
TTGGTGCGCTT -> TGGTGCGCTTA
TTGTAAGTATA -> TGTAAGTATAC
TTGTACTACCT -> TGTACTACCTT
TTGTATTTAGA -> TGTATTTAGAC
TTGTCCCTTCG -> TGTCCCTTCGA
TTGTCCGACAG -> TGTCCGACAGC
TTGTCTGGATT -> TGTCTGGATTT
TTGTGAAGCTC -> TGTGAAGCTCA
TTGTGACCATA -> TGTGACCATAT
TTGTGTACAAG -> TGTGTACAAGA
TTGTTGTCTGG -> TGTTGTCTGGA
TTTAAAGCCGT -> TTAAAGCCGTC
TTTAACAGGCT -> TTAACAGGCTA
TTTACGTTAAG -> TTACGTTAAGT
TTTAGACCTCC -> TTAGACCTCCA
TTTATCCGGAC -> TTATCCGGACC
TTTATCGACTT -> TTATCGACTTC,TTATCGACTTT
TTTATTAAATG -> TTATTAAATGA
TTTCAGCCACT -> TTCAGCCACTA
TTTCAGGTACC -> TTCAGGTACCA
TTTCATTATAC -> TTCATTATACC
TTTCTTGGCAC -> TTCTTGGCACT
TTTGCAACCGA -> TTGCAACCGAT
TTTGCAGTAAT -> TTGCAGTAATA
TTTGGACGAGC -> TTGGACGAGCT
TTTGGAGTAAA -> TTGGAGTAAAC
TTTGGCAGTCG -> TTGGCAGTCGC
TTTGGGCAGTT -> TTGGGCAGTTA
TTTGTGAAGCT -> TTGTGAAGCTC
TTTGTTGTCTG -> TTGTTGTCTGG
TTTTATCGACT -> TTTATCGACTT
TTTTCTTGGCA -> TTTCTTGGCAC
TTTTGCAACCG -> TTTGCAACCGA
TTTTGGAGTAA -> TTTGGAGTAAA
TTTTTCTTGGC -> TTTTCTTGGCA
TTTTTGGAGTA -> TTTTGGAGTAA
TTTTTTGGAGT -> TTTTTGGAGTA
