AAAAAAAGTGCCTCTGCAA -> AAAAAAGTGCCTCTGCAAT
AAAAAAGTCTACAAGCCAC -> AAAAAGTCTACAAGCCACA
AAAAAAGTGCCTCTGCAAT -> AAAAAGTGCCTCTGCAATT
AAAAACCCACGTGCATGTT -> AAAACCCACGTGCATGTTC
AAAAAGTCTACAAGCCACA -> AAAAGTCTACAAGCCACAG
AAAAAGTGCCTCTGCAATT -> AAAAGTGCCTCTGCAATTA
AAAACAAATTCGACACCGC -> AAACAAATTCGACACCGCG
AAAACCCACGTGCATGTTC -> AAACCCACGTGCATGTTCT
AAAACCCCATTGTGCGCCT -> AAACCCCATTGTGCGCCTA
AAAACCTAACTCACCATGC -> AAACCTAACTCACCATGCG
AAAAGGGACGGTTCGGATT -> AAAGGGACGGTTCGGATTA
AAAAGTCTACAAGCCACAG -> AAAGTCTACAAGCCACAGG
AAAAGTGCCTCTGCAATTA -> AAAGTGCCTCTGCAATTAG
AAAATTAACGCGTTGAGGT -> AAATTAACGCGTTGAGGTC
AAACAAATTCGACACCGCG -> AACAAATTCGACACCGCGT
AAACAAGCCCCGAACGTTG -> AACAAGCCCCGAACGTTGC
AAACCAGATGGAGCCTAGT -> AACCAGATGGAGCCTAGTA
AAACCCACGTGCATGTTCT -> AACCCACGTGCATGTTCTT
AAACCCCATTGTGCGCCTA -> AACCCCATTGTGCGCCTAC
AAACCTAACTCACCATGCG -> AACCTAACTCACCATGCGC
AAACTGGTTTCCTGGTGGT -> AACTGGTTTCCTGGTGGTA
AAACTTATCTTTCACAAGT -> AACTTATCTTTCACAAGTC
AAACTTCGAAGAAAACCTA -> AACTTCGAAGAAAACCTAA
AAAGACGATGCTGTGGCTG -> AAGACGATGCTGTGGCTGG
AAAGCATTATTAGATGGAG -> AAGCATTATTAGATGGAGT
AAAGGAGATTCATGTGCAC -> AAGGAGATTCATGTGCACA
AAAGGCTTGCCCAACCCTA -> AAGGCTTGCCCAACCCTAA
AAAGGGACGGTTCGGATTA -> AAGGGACGGTTCGGATTAT
AAAGTCTACAAGCCACAGG -> AAGTCTACAAGCCACAGGG
AAAGTGCCTCTGCAATTAG -> AAGTGCCTCTGCAATTAGA
AAAGTGCTGGCGCACGTCG -> AAGTGCTGGCGCACGTCGG
AAATCGTAACGTCTATACC -> AATCGTAACGTCTATACCT
AAATGCGCCTCGGAATGAT -> AATGCGCCTCGGAATGATT
AAATTAACGCGTTGAGGTC -> AATTAACGCGTTGAGGTCT
AAATTCCCGATCACACGCA -> AATTCCCGATCACACGCAC
AAATTCGACACCGCGTTCG -> AATTCGACACCGCGTTCGA
AAATTCGGTTTTTCATAAG -> AATTCGGTTTTTCATAAGC
AAATTCTGGACATGCACAC -> AATTCTGGACATGCACACT
AACAAATTCGACACCGCGT -> ACAAATTCGACACCGCGTT
AACAAGCCCCGAACGTTGC -> ACAAGCCCCGAACGTTGCC
AACACATTGAGTAATGAAG -> ACACATTGAGTAATGAAGC
AACAGAAATGCGCCTCGGA -> ACAGAAATGCGCCTCGGAA
AACAGATACATGTTTTGGT -> ACAGATACATGTTTTGGTT
AACATCAAAGGAGATTCAT -> ACATCAAAGGAGATTCATG
AACATGAGTCTGCTGGACA -> ACATGAGTCTGCTGGACAT
AACATGGGGCCTCTCGTTA -> ACATGGGGCCTCTCGTTAG
AACCACGCGATTTGTCCGT -> ACCACGCGATTTGTCCGTC
AACCAGATGGAGCCTAGTA -> ACCAGATGGAGCCTAGTAA
AACCCACGTGCATGTTCTT -> ACCCACGTGCATGTTCTTG
AACCCCATTGTGCGCCTAC -> ACCCCATTGTGCGCCTACC
AACCCGGACATGGAGGCAG -> ACCCGGACATGGAGGCAGG
AACCCTAACTGGATGAACA -> ACCCTAACTGGATGAACAT
AACCCTACCACCAATTCTG -> ACCCTACCACCAATTCTGC
AACCTAACTCACCATGCGC -> ACCTAACTCACCATGCGCA
AACCTGGGGAGACAGCGCG -> ACCTGGGGAGACAGCGCGC
AACGAATTCTCAAGGGGGT -> ACGAATTCTCAAGGGGGTG
AACGACCCTTGCTAGACGA -> ACGACCCTTGCTAGACGAA
AACGAGCGGAATAAAAACC -> ACGAGCGGAATAAAAACCC
AACGCACACGGCGGGGGAA -> ACGCACACGGCGGGGGAAA
AACGCGTTGAGGTCTCTTG -> ACGCGTTGAGGTCTCTTGG
AACGCTCGACTAACCCTAC -> ACGCTCGACTAACCCTACC
AACGTAGACCATTTTCCTG -> ACGTAGACCATTTTCCTGG
AACGTCATCGGCTGATAGT -> ACGTCATCGGCTGATAGTG
AACGTCTATACCTGCTGAA -> ACGTCTATACCTGCTGAAG
AACGTGTTTATGTGTGAGA -> ACGTGTTTATGTGTGAGAA
AACGTTGCCCATCCGGCGC -> ACGTTGCCCATCCGGCGCG
AACGTTGCCGACTGGACAT -> ACGTTGCCGACTGGACATG
AACTAATCGTAGAAACAAG -> ACTAATCGTAGAAACAAGC
AACTAGCAATGATCCAGGC -> ACTAGCAATGATCCAGGCC
AACTAGTTTCGTTCTAACG -> ACTAGTTTCGTTCTAACGA
AACTCACCATGCGCACCCT -> ACTCACCATGCGCACCCTT
AACTGATGGCGCTGCACAC -> ACTGATGGCGCTGCACACG
AACTGGATGAACATGGGGC -> ACTGGATGAACATGGGGCC
AACTGGCGGTACTTGTCAG -> ACTGGCGGTACTTGTCAGT
AACTGGTTTCCTGGTGGTA -> ACTGGTTTCCTGGTGGTAT
AACTTATCTTTCACAAGTC -> ACTTATCTTTCACAAGTCG
AACTTCGAAGAAAACCTAA -> ACTTCGAAGAAAACCTAAC
AAGAAAACCTAACTCACCA -> AGAAAACCTAACTCACCAT
AAGAATTGTGCGCGAGACA -> AGAATTGTGCGCGAGACAT
AAGACGATGCTGTGGCTGG -> AGACGATGCTGTGGCTGGA
AAGCATCACGATCTCGTAG -> AGCATCACGATCTCGTAGC
AAGCATTATTAGATGGAGT -> AGCATTATTAGATGGAGTT
AAGCCACAACTGGCGGTAC -> AGCCACAACTGGCGGTACT
AAGCCACAGGGCAGTCCTG -> AGCCACAGGGCAGTCCTGC
AAGCCCCGAACGTTGCCCA -> AGCCCCGAACGTTGCCCAT
AAGCCCGCCCATGAAAGGC -> AGCCCGCCCATGAAAGGCT
AAGCCGAAACTTATCTTTC -> AGCCGAAACTTATCTTTCA
AAGCCTGATGCACCGCTCG -> AGCCTGATGCACCGCTCGA
AAGCGCGCCGATTAGTGAG -> AGCGCGCCGATTAGTGAGC
AAGCGTTGGAAAAAAGTCT -> AGCGTTGGAAAAAAGTCTA
AAGCTCGAACTAGCAATGA -> AGCTCGAACTAGCAATGAT
AAGCTGCTCCTATGATGCC -> AGCTGCTCCTATGATGCCG
AAGGAGATTCATGTGCACA -> AGGAGATTCATGTGCACAC
AAGGCTTGCCCAACCCTAA -> AGGCTTGCCCAACCCTAAC
AAGGGACGGTTCGGATTAT -> AGGGACGGTTCGGATTATA
AAGGGGGTGCCCTCTAATA -> AGGGGGTGCCCTCTAATAC
AAGTCGTTGCCTCCGCGGA -> AGTCGTTGCCTCCGCGGAA
AAGTCTAATGGCTTTCGCA -> AGTCTAATGGCTTTCGCAT
AAGTCTACAAGCCACAGGG -> AGTCTACAAGCCACAGGGC
AAGTGCCTCTGCAATTAGA -> AGTGCCTCTGCAATTAGAA
AAGTGCTGGCGCACGTCGG -> AGTGCTGGCGCACGTCGGT
AAGTGGCTGGACAAAAGGG -> AGTGGCTGGACAAAAGGGA
AAGTTATCCATGCGTGTTC -> AGTTATCCATGCGTGTTCA
AAGTTGGACTTACAGGGTC -> AGTTGGACTTACAGGGTCC
AAGTTGGGAACAGAAATGC -> AGTTGGGAACAGAAATGCG
AATAAAAACCCACGTGCAT -> ATAAAAACCCACGTGCATG
AATAACGTTGCCGACTGGA -> ATAACGTTGCCGACTGGAC
AATACACGAGGATCGCTGC -> ATACACGAGGATCGCTGCT
AATACCCAGATGAAAGCAT -> ATACCCAGATGAAAGCATT
AATATTATGTGATCGTAAA -> ATATTATGTGATCGTAAAA
AATCAGCAGTGGTTACGTT -> ATCAGCAGTGGTTACGTTG
AATCGATGGGGCCAAGTTG -> ATCGATGGGGCCAAGTTGG
AATCGCAAATTCTGGACAT -> ATCGCAAATTCTGGACATG
AATCGTAACGTCTATACCT -> ATCGTAACGTCTATACCTG
AATCGTAGAAACAAGCCCC -> ATCGTAGAAACAAGCCCCG
AATGAAGCCTGATGCACCG -> ATGAAGCCTGATGCACCGC
AATGATCCAGGCCCCTGCA -> ATGATCCAGGCCCCTGCAC
AATGATTTACGACCGATGT -> ATGATTTACGACCGATGTA
AATGCGCCTCGGAATGATT -> ATGCGCCTCGGAATGATTT
AATGCTAGTCAAGAATTGT -> ATGCTAGTCAAGAATTGTG
AATGGCTTTCGCATGCGTA -> ATGGCTTTCGCATGCGTAT
AATGTGAGGCGCCGACATT -> ATGTGAGGCGCCGACATTA
AATTAACGCGTTGAGGTCT -> ATTAACGCGTTGAGGTCTC
AATTAAGCTGCTCCTATGA -> ATTAAGCTGCTCCTATGAT
AATTACATCGTAATTTTGA -> ATTACATCGTAATTTTGAG
AATTAGAACATGAGTCTGC -> ATTAGAACATGAGTCTGCT
AATTCCATCACCGACATTA -> ATTCCATCACCGACATTAG
AATTCCCGATCACACGCAC -> ATTCCCGATCACACGCACG
AATTCGACACCGCGTTCGA -> ATTCGACACCGCGTTCGAC
AATTCGGTTTTTCATAAGC -> ATTCGGTTTTTCATAAGCC
AATTCTCAAGGGGGTGCCC -> ATTCTCAAGGGGGTGCCCT
AATTCTGCGGGCTCTAACA -> ATTCTGCGGGCTCTAACAT
AATTCTGGACATGCACACT -> ATTCTGGACATGCACACTG
AATTGTGCGCGAGACATAC -> ATTGTGCGCGAGACATACA
AATTTTGAGTAGGGAACTA -> ATTTTGAGTAGGGAACTAA
ACAAAAGGGACGGTTCGGA -> CAAAAGGGACGGTTCGGAT
ACAAATTCGACACCGCGTT -> CAAATTCGACACCGCGTTC
ACAACGTCATCGGCTGATA -> CAACGTCATCGGCTGATAG
ACAACTAGTTTCGTTCTAA -> CAACTAGTTTCGTTCTAAC
ACAACTGGCGGTACTTGTC -> CAACTGGCGGTACTTGTCA
ACAAGCCACAGGGCAGTCC -> CAAGCCACAGGGCAGTCCT
ACAAGCCCCGAACGTTGCC -> CAAGCCCCGAACGTTGCCC
ACAAGTCGTTGCCTCCGCG -> CAAGTCGTTGCCTCCGCGG
ACACATTGAGTAATGAAGC -> CACATTGAGTAATGAAGCC
ACACCCAACACATTGAGTA -> CACCCAACACATTGAGTAA
ACACCGCGTTCGACCTCAG -> CACCGCGTTCGACCTCAGG
ACACCTTGTAGCGTGCGAT -> CACCTTGTAGCGTGCGATC
ACACGAGGATCGCTGCTCC -> CACGAGGATCGCTGCTCCG
ACACGCACGAGTATGCATA -> CACGCACGAGTATGCATAC
ACACGGCGGGGGAAAAAAA -> CACGGCGGGGGAAAAAAAG
ACACGTCTCCCTATGACGA -> CACGTCTCCCTATGACGAT
ACACGTCTGTGCCACATGA -> CACGTCTGTGCCACATGAT
ACACTATGTGCGACTTATT -> CACTATGTGCGACTTATTC
ACACTGTCAATGTGAGGCG -> CACTGTCAATGTGAGGCGC
ACACTGTCCGATTTGCAGT -> CACTGTCCGATTTGCAGTC
ACACTGTCGAATTCCATCA -> CACTGTCGAATTCCATCAC
ACACTGTCTTGCGTGAGTC -> CACTGTCTTGCGTGAGTCC
ACACTTATCGGCTTCGCGT -> CACTTATCGGCTTCGCGTT
ACAGAAATGCGCCTCGGAA -> CAGAAATGCGCCTCGGAAT
ACAGATACATGTTTTGGTT -> CAGATACATGTTTTGGTTC
ACAGATGGGCGGTAATAAC -> CAGATGGGCGGTAATAACG
ACAGCAGCCTTAAGCGCGC -> CAGCAGCCTTAAGCGCGCC
ACAGCGCGCCTGTGGGTGA -> CAGCGCGCCTGTGGGTGAC
ACAGGCTATGGGGATATTG -> CAGGCTATGGGGATATTGA
ACAGGGCAGTCCTGCAAAG -> CAGGGCAGTCCTGCAAAGA
ACAGGGTCCAAATTCCCGA -> CAGGGTCCAAATTCCCGAT
ACAGGTCTTTTACGCCCCA -> CAGGTCTTTTACGCCCCAA
ACAGTACAGGTCTTTTACG -> CAGTACAGGTCTTTTACGC
ACATACATTAAACTTCGAA -> CATACATTAAACTTCGAAG
ACATCAAAGGAGATTCATG -> CATCAAAGGAGATTCATGT
ACATCATCTCGGCCCTGCT -> CATCATCTCGGCCCTGCTG
ACATCGTAATTTTGAGTAG -> CATCGTAATTTTGAGTAGG
ACATGAGTCTGCTGGACAT -> CATGAGTCTGCTGGACATG
ACATGATGCCCCAAGTTGG -> CATGATGCCCCAAGTTGGG
ACATGATGGCTTACCAACC -> CATGATGGCTTACCAACCC
ACATGCACACTGTCAATGT -> CATGCACACTGTCAATGTG
ACATGCACACTGTCCGATT -> CATGCACACTGTCCGATTT
ACATGCACACTGTCGAATT -> CATGCACACTGTCGAATTC
ACATGCACACTGTCTTGCG -> CATGCACACTGTCTTGCGT
ACATGCATACCATGGATTG -> CATGCATACCATGGATTGT
ACATGGAGGCAGGGTGCAA -> CATGGAGGCAGGGTGCAAA
ACATGGGGCCTCTCGTTAG -> CATGGGGCCTCTCGTTAGT
ACATGTTTTGGTTCCGCAC -> CATGTTTTGGTTCCGCACA
ACATTAAACTTCGAAGAAA -> CATTAAACTTCGAAGAAAA
ACATTAGGTGTGTTTGGAA -> CATTAGGTGTGTTTGGAAG
ACATTAGGTGTGTTTGGAG -> CATTAGGTGTGTTTGGAGG
ACATTAGGTGTGTTTGTCG -> CATTAGGTGTGTTTGTCGT
ACATTAGGTGTGTTTGTGA -> CATTAGGTGTGTTTGTGAG
ACATTGAGTAATGAAGCCT -> CATTGAGTAATGAAGCCTG
ACCAACCCGGACATGGAGG -> CCAACCCGGACATGGAGGC
ACCAATTCTGCGGGCTCTA -> CCAATTCTGCGGGCTCTAA
ACCACCAATTCTGCGGGCT -> CCACCAATTCTGCGGGCTC
ACCACCCCAACGCTCGACT -> CCACCCCAACGCTCGACTA
ACCACGCGATTTGTCCGTC -> CCACGCGATTTGTCCGTCC
ACCAGATGCGCACGATGAC -> CCAGATGCGCACGATGACA
ACCAGATGGAGCCTAGTAA -> CCAGATGGAGCCTAGTAAA
ACCATGATCCTGAGTGAAT -> CCATGATCCTGAGTGAATA
ACCATGCGCACCCTTATCG -> CCATGCGCACCCTTATCGG
ACCATGGATTGTACTGGGC -> CCATGGATTGTACTGGGCC
ACCATTTTCCTGGACATGC -> CCATTTTCCTGGACATGCA
ACCCAACACATTGAGTAAT -> CCCAACACATTGAGTAATG
ACCCACGTGCATGTTCTTG -> CCCACGTGCATGTTCTTGG
ACCCAGATGAAAGCATTAT -> CCCAGATGAAAGCATTATT
ACCCCAACGCTCGACTAAC -> CCCCAACGCTCGACTAACC
ACCCCATTGTGCGCCTACC -> CCCCATTGTGCGCCTACCA
ACCCGGACATGGAGGCAGG -> CCCGGACATGGAGGCAGGG
ACCCTAACTGGATGAACAT -> CCCTAACTGGATGAACATG
ACCCTACCACCAATTCTGC -> CCCTACCACCAATTCTGCG
ACCCTCCTTTATACAACTA -> CCCTCCTTTATACAACTAG
ACCCTTATCGGGCGTCAAA -> CCCTTATCGGGCGTCAAAG
ACCCTTGCTAGACGAACGT -> CCCTTGCTAGACGAACGTA
ACCGACATTAGGTGTGTTT -> CCGACATTAGGTGTGTTTG
ACCGATGTATCACGGGGCA -> CCGATGTATCACGGGGCAT
ACCGCGTTCGACCTCAGGC -> CCGCGTTCGACCTCAGGCC
ACCGCTCGAAAGACGATGC -> CCGCTCGAAAGACGATGCT
ACCTAACTCACCATGCGCA -> CCTAACTCACCATGCGCAC
ACCTCAGGCCTACCTGTCA -> CCTCAGGCCTACCTGTCAA
ACCTGCTGAAGTCTAATGG -> CCTGCTGAAGTCTAATGGC
ACCTGGGGAGACAGCGCGC -> CCTGGGGAGACAGCGCGCC
ACCTGTCAAACTGGTTTCC -> CCTGTCAAACTGGTTTCCT
ACCTTGTAGCGTGCGATCA -> CCTTGTAGCGTGCGATCAA
ACGAACGTAGACCATTTTC -> CGAACGTAGACCATTTTCC
ACGAATTCTCAAGGGGGTG -> CGAATTCTCAAGGGGGTGC
ACGACAGTACAGGTCTTTT -> CGACAGTACAGGTCTTTTA
ACGACCCTTGCTAGACGAA -> CGACCCTTGCTAGACGAAC
ACGACCGATGTATCACGGG -> CGACCGATGTATCACGGGG
ACGAGCGGAATAAAAACCC -> CGAGCGGAATAAAAACCCA
ACGAGGATCGCTGCTCCGG -> CGAGGATCGCTGCTCCGGG
ACGAGTATGCATACAGATG -> CGAGTATGCATACAGATGG
ACGATCCCCGTAACAGATA -> CGATCCCCGTAACAGATAC
ACGATCTCGTAGCCCTAAC -> CGATCTCGTAGCCCTAACG
ACGATGACACTTATCGGCT -> CGATGACACTTATCGGCTT
ACGATGCTGTGGCTGGAAT -> CGATGCTGTGGCTGGAATG
ACGATTTTTCTCGTCTACA -> CGATTTTTCTCGTCTACAC
ACGCACACGGCGGGGGAAA -> CGCACACGGCGGGGGAAAA
ACGCACGAGTATGCATACA -> CGCACGAGTATGCATACAG
ACGCCCCAACCACGCGATT -> CGCCCCAACCACGCGATTT
ACGCGATTTGTCCGTCCGT -> CGCGATTTGTCCGTCCGTC
ACGCGTTGAGGTCTCTTGG -> CGCGTTGAGGTCTCTTGGC
ACGCTCGACTAACCCTACC -> CGCTCGACTAACCCTACCA
ACGGACACCTTGTAGCGTG -> CGGACACCTTGTAGCGTGC
ACGGCGGGGGAAAAAAAGT -> CGGCGGGGGAAAAAAAGTG
ACGGGGCATAATCGATGGG -> CGGGGCATAATCGATGGGG
ACGGTACACTATGTGCGAC -> CGGTACACTATGTGCGACT
ACGGTCAGTCTAATCGCAA -> CGGTCAGTCTAATCGCAAA
ACGGTTCGGATTATACGGT -> CGGTTCGGATTATACGGTA
ACGTAGACCATTTTCCTGG -> CGTAGACCATTTTCCTGGA
ACGTAGTCTCGGGGATCTT -> CGTAGTCTCGGGGATCTTA
ACGTCACTCACGTAGTCTC -> CGTCACTCACGTAGTCTCG
ACGTCATCGGCTGATAGTG -> CGTCATCGGCTGATAGTGC
ACGTCGGTGCTTATCTTCC -> CGTCGGTGCTTATCTTCCT
ACGTCTATACCTGCTGAAG -> CGTCTATACCTGCTGAAGT
ACGTCTCCCTATGACGATC -> CGTCTCCCTATGACGATCC
ACGTCTGTGCCACATGATG -> CGTCTGTGCCACATGATGG
ACGTGCATGTTCTTGGCAA -> CGTGCATGTTCTTGGCAAG
ACGTGTTTATGTGTGAGAA -> CGTGTTTATGTGTGAGAAG
ACGTTGCCCATCCGGCGCG -> CGTTGCCCATCCGGCGCGC
ACGTTGCCGACTGGACATG -> CGTTGCCGACTGGACATGC
ACGTTGTCGCTCCGAGTCA -> CGTTGTCGCTCCGAGTCAG
ACTAACCCTACCACCAATT -> CTAACCCTACCACCAATTC
ACTAATCGTAGAAACAAGC -> CTAATCGTAGAAACAAGCC
ACTACAACGTCATCGGCTG -> CTACAACGTCATCGGCTGA
ACTAGCAATGATCCAGGCC -> CTAGCAATGATCCAGGCCC
ACTAGTTTCGTTCTAACGA -> CTAGTTTCGTTCTAACGAA
ACTATGTGCGACTTATTCG -> CTATGTGCGACTTATTCGA
ACTCACCATGCGCACCCTT -> CTCACCATGCGCACCCTTA
ACTCACGGTCAGTCTAATC -> CTCACGGTCAGTCTAATCG
ACTCACGTAGTCTCGGGGA -> CTCACGTAGTCTCGGGGAT
ACTCATCTTACCACCCCAA -> CTCATCTTACCACCCCAAC
ACTCCGGTGAGAATTACAT -> CTCCGGTGAGAATTACATC
ACTGAGATAACTGATGGCG -> CTGAGATAACTGATGGCGC
ACTGATGGCGCTGCACACG -> CTGATGGCGCTGCACACGT
ACTGGACATGCACACTGTC -> CTGGACATGCACACTGTCA
ACTGGATGAACATGGGGCC -> CTGGATGAACATGGGGCCT
ACTGGCGGTACTTGTCAGT -> CTGGCGGTACTTGTCAGTG
ACTGGGCCCCAAGCGTTGG -> CTGGGCCCCAAGCGTTGGA
ACTGGTTTCCTGGTGGTAT -> CTGGTTTCCTGGTGGTATA
ACTGTATTCGAGCCACCCT -> CTGTATTCGAGCCACCCTC
ACTGTCAATGTGAGGCGCC -> CTGTCAATGTGAGGCGCCG
ACTGTCCGATTTGCAGTCC -> CTGTCCGATTTGCAGTCCG
ACTGTCGAATTCCATCACC -> CTGTCGAATTCCATCACCG
ACTGTCTTGCGTGAGTCCC -> CTGTCTTGCGTGAGTCCCG
ACTTACAGGGTCCAAATTC -> CTTACAGGGTCCAAATTCC
ACTTACTACAACGTCATCG -> CTTACTACAACGTCATCGG
ACTTATCGGCTTCGCGTTA -> CTTATCGGCTTCGCGTTAT
ACTTATCTTTCACAAGTCG -> CTTATCTTTCACAAGTCGT
ACTTATGAAGCCGAAACTT -> CTTATGAAGCCGAAACTTA
ACTTATTCGACATGATGCC -> CTTATTCGACATGATGCCC
ACTTCGAAGAAAACCTAAC -> CTTCGAAGAAAACCTAACT
ACTTCTCCACAGCAGCCTT -> CTTCTCCACAGCAGCCTTA
ACTTGTCAGTGCCTGACTC -> CTTGTCAGTGCCTGACTCA
AGAAAACCTAACTCACCAT -> GAAAACCTAACTCACCATG
AGAAACAAGCCCCGAACGT -> GAAACAAGCCCCGAACGTT
AGAAATGCGCCTCGGAATG -> GAAATGCGCCTCGGAATGA
AGAAATTCGGTTTTTCATA -> GAAATTCGGTTTTTCATAA
AGAACATGAGTCTGCTGGA -> GAACATGAGTCTGCTGGAC
AGAAGTGGCTGGACAAAAG -> GAAGTGGCTGGACAAAAGG
AGAATTACATCGTAATTTT -> GAATTACATCGTAATTTTG
AGAATTGTGCGCGAGACAT -> GAATTGTGCGCGAGACATA
AGACAGCGCGCCTGTGGGT -> GACAGCGCGCCTGTGGGTG
AGACAGGCTATGGGGATAT -> GACAGGCTATGGGGATATT
AGACATACATTAAACTTCG -> GACATACATTAAACTTCGA
AGACCATTTTCCTGGACAT -> GACCATTTTCCTGGACATG
AGACGAACGTAGACCATTT -> GACGAACGTAGACCATTTT
AGACGATGCTGTGGCTGGA -> GACGATGCTGTGGCTGGAA
AGATAACTGATGGCGCTGC -> GATAACTGATGGCGCTGCA
AGATACATGTTTTGGTTCC -> GATACATGTTTTGGTTCCG
AGATGAAAGCATTATTAGA -> GATGAAAGCATTATTAGAT
AGATGCGCACGATGACACT -> GATGCGCACGATGACACTT
AGATGGAGCCTAGTAAAAC -> GATGGAGCCTAGTAAAACA
AGATGGAGTTCATACTTCT -> GATGGAGTTCATACTTCTC
AGATGGGCGGTAATAACGT -> GATGGGCGGTAATAACGTT
AGATTCATGTGCACACGTC -> GATTCATGTGCACACGTCT
AGCAATGATCCAGGCCCCT -> GCAATGATCCAGGCCCCTG
AGCAGCCTTAAGCGCGCCG -> GCAGCCTTAAGCGCGCCGA
AGCAGTGGTTACGTTGTCG -> GCAGTGGTTACGTTGTCGC
AGCATCACGATCTCGTAGC -> GCATCACGATCTCGTAGCC
AGCATGTGACGGACACCTT -> GCATGTGACGGACACCTTG
AGCATTATTAGATGGAGTT -> GCATTATTAGATGGAGTTC
AGCCACAACTGGCGGTACT -> GCCACAACTGGCGGTACTT
AGCCACAGGGCAGTCCTGC -> GCCACAGGGCAGTCCTGCA
AGCCACCCTCCTTTATACA -> GCCACCCTCCTTTATACAA
AGCCCCGAACGTTGCCCAT -> GCCCCGAACGTTGCCCATC
AGCCCGCCCATGAAAGGCT -> GCCCGCCCATGAAAGGCTT
AGCCCTAACGAGCGGAATA -> GCCCTAACGAGCGGAATAA
AGCCGAAACTTATCTTTCA -> GCCGAAACTTATCTTTCAC
AGCCGTCAGAAATTCGGTT -> GCCGTCAGAAATTCGGTTT
AGCCGTTAAGCATCACGAT -> GCCGTTAAGCATCACGATC
AGCCTAGTAAAACAAATTC -> GCCTAGTAAAACAAATTCG
AGCCTGATGCACCGCTCGA -> GCCTGATGCACCGCTCGAA
AGCCTTAAGCGCGCCGATT -> GCCTTAAGCGCGCCGATTA
AGCGCGCCGATTAGTGAGC -> GCGCGCCGATTAGTGAGCA
AGCGCGCCTGTGGGTGACG -> GCGCGCCTGTGGGTGACGA
AGCGGAACCTGGGGAGACA -> GCGGAACCTGGGGAGACAG
AGCGGAATAAAAACCCACG -> GCGGAATAAAAACCCACGT
AGCGTGCGATCAACGCACA -> GCGTGCGATCAACGCACAC
AGCGTTGGAAAAAAGTCTA -> GCGTTGGAAAAAAGTCTAC
AGCTCGAACTAGCAATGAT -> GCTCGAACTAGCAATGATC
AGCTGCTCCTATGATGCCG -> GCTGCTCCTATGATGCCGA
AGCTGTCCGGAGTCTCAGC -> GCTGTCCGGAGTCTCAGCG
AGGAGATTCATGTGCACAC -> GGAGATTCATGTGCACACG
AGGATCGCTGCTCCGGGCG -> GGATCGCTGCTCCGGGCGC
AGGCAGGGTGCAAACCAGA -> GGCAGGGTGCAAACCAGAT
AGGCCCCTGCACTTATGAA -> GGCCCCTGCACTTATGAAG
AGGCCTACCTGTCAAACTG -> GGCCTACCTGTCAAACTGG
AGGCGAAAACCCCATTGTG -> GGCGAAAACCCCATTGTGC
AGGCGCCGACATTAGGTGT -> GGCGCCGACATTAGGTGTG
AGGCTAGCCGTTAAGCATC -> GGCTAGCCGTTAAGCATCA
AGGCTATGGGGATATTGAC -> GGCTATGGGGATATTGACT
AGGCTTGCCCAACCCTAAC -> GGCTTGCCCAACCCTAACT
AGGGAACTAATCGTAGAAA -> GGGAACTAATCGTAGAAAC
AGGGACGGTTCGGATTATA -> GGGACGGTTCGGATTATAC
AGGGCAGTCCTGCAAAGAT -> GGGCAGTCCTGCAAAGATT
AGGGGGTGCCCTCTAATAC -> GGGGGTGCCCTCTAATACC
AGGGTCCAAATTCCCGATC -> GGGTCCAAATTCCCGATCA
AGGGTGCAAACCAGATGGA -> GGGTGCAAACCAGATGGAG
AGGTCTCTTGGCTGCGGAT -> GGTCTCTTGGCTGCGGATG
AGGTCTTTTACGCCCCAAC -> GGTCTTTTACGCCCCAACC
AGGTGTGTTTGGAAGTTAT -> GGTGTGTTTGGAAGTTATC
AGGTGTGTTTGGAGGTTGA -> GGTGTGTTTGGAGGTTGAA
AGGTGTGTTTGTCGTAACG -> GGTGTGTTTGTCGTAACGA
AGGTGTGTTTGTGAGGCTA -> GGTGTGTTTGTGAGGCTAG
AGGTTGAACGTGTTTATGT -> GGTTGAACGTGTTTATGTG
AGTAAAACAAATTCGACAC -> GTAAAACAAATTCGACACC
AGTAATGAAGCCTGATGCA -> GTAATGAAGCCTGATGCAC
AGTACAGGTCTTTTACGCC -> GTACAGGTCTTTTACGCCC
AGTAGGGAACTAATCGTAG -> GTAGGGAACTAATCGTAGA
AGTATGCATACAGATGGGC -> GTATGCATACAGATGGGCG
AGTCAAGAATTGTGCGCGA -> GTCAAGAATTGTGCGCGAG
AGTCAGGCGAAAACCCCAT -> GTCAGGCGAAAACCCCATT
AGTCCCGACATTAGGTGTG -> GTCCCGACATTAGGTGTGT
AGTCCGACATTAGGTGTGT -> GTCCGACATTAGGTGTGTT
AGTCGTTGCCTCCGCGGAA -> GTCGTTGCCTCCGCGGAAT
AGTCTAATCGCAAATTCTG -> GTCTAATCGCAAATTCTGG
AGTCTAATGGCTTTCGCAT -> GTCTAATGGCTTTCGCATG
AGTCTACAAGCCACAGGGC -> GTCTACAAGCCACAGGGCA
AGTCTCAGCGGAACCTGGG -> GTCTCAGCGGAACCTGGGG
AGTCTCGGGGATCTTAGAC -> GTCTCGGGGATCTTAGACA
AGTCTGCTGGACATGCACA -> GTCTGCTGGACATGCACAC
AGTGAATACACGAGGATCG -> GTGAATACACGAGGATCGC
AGTGAGCATGTGACGGACA -> GTGAGCATGTGACGGACAC
AGTGCCTCTGCAATTAGAA -> GTGCCTCTGCAATTAGAAC
AGTGCCTGACTCACGGTCA -> GTGCCTGACTCACGGTCAG
AGTGCTATTTATGATGATC -> GTGCTATTTATGATGATCA
AGTGCTGGCGCACGTCGGT -> GTGCTGGCGCACGTCGGTG
AGTGGCACTGAGATAACTG -> GTGGCACTGAGATAACTGA
AGTGGCTGGACAAAAGGGA -> GTGGCTGGACAAAAGGGAC
AGTGGTATTCATATTACAT -> GTGGTATTCATATTACATG
AGTGGTTACGTTGTCGCTC -> GTGGTTACGTTGTCGCTCC
AGTTACTCATCTTACCACC -> GTTACTCATCTTACCACCC
AGTTATCCATGCGTGTTCA -> GTTATCCATGCGTGTTCAC
AGTTCATACTTCTCCACAG -> GTTCATACTTCTCCACAGC
AGTTGGACTTACAGGGTCC -> GTTGGACTTACAGGGTCCA
AGTTGGGAACAGAAATGCG -> GTTGGGAACAGAAATGCGC
AGTTTCGTTCTAACGAATT -> GTTTCGTTCTAACGAATTC
ATAAAAACCCACGTGCATG -> TAAAAACCCACGTGCATGT
ATAACGTTGCCGACTGGAC -> TAACGTTGCCGACTGGACA
ATAACTGATGGCGCTGCAC -> TAACTGATGGCGCTGCACA
ATAAGCCCGCCCATGAAAG -> TAAGCCCGCCCATGAAAGG
ATAATCGATGGGGCCAAGT -> TAATCGATGGGGCCAAGTT
ATACAACTAGTTTCGTTCT -> TACAACTAGTTTCGTTCTA
ATACACGAGGATCGCTGCT -> TACACGAGGATCGCTGCTC
ATACAGATGGGCGGTAATA -> TACAGATGGGCGGTAATAA
ATACATGTTTTGGTTCCGC -> TACATGTTTTGGTTCCGCA
ATACATTAAACTTCGAAGA -> TACATTAAACTTCGAAGAA
ATACCATGGATTGTACTGG -> TACCATGGATTGTACTGGG
ATACCCAGATGAAAGCATT -> TACCCAGATGAAAGCATTA
ATACCTGCTGAAGTCTAAT -> TACCTGCTGAAGTCTAATG
ATACGATTTTTCTCGTCTA -> TACGATTTTTCTCGTCTAC
ATACGGTACACTATGTGCG -> TACGGTACACTATGTGCGA
ATACTTCTCCACAGCAGCC -> TACTTCTCCACAGCAGCCT
ATAGTGCTATTTATGATGA -> TAGTGCTATTTATGATGAT
ATATTACATGCATACCATG -> TATTACATGCATACCATGG
ATATTATGTGATCGTAAAA -> TATTATGTGATCGTAAAAT
ATATTGACTGTATTCGAGC -> TATTGACTGTATTCGAGCC
ATCAAAGGAGATTCATGTG -> TCAAAGGAGATTCATGTGC
ATCAACGCACACGGCGGGG -> TCAACGCACACGGCGGGGG
ATCACACGCACGAGTATGC -> TCACACGCACGAGTATGCA
ATCACCGACATTAGGTGTG -> TCACCGACATTAGGTGTGT
ATCACGATCTCGTAGCCCT -> TCACGATCTCGTAGCCCTA
ATCACGGGGCATAATCGAT -> TCACGGGGCATAATCGATG
ATCAGCAGTGGTTACGTTG -> TCAGCAGTGGTTACGTTGT
ATCAGTGGCACTGAGATAA -> TCAGTGGCACTGAGATAAC
ATCATCTCGGCCCTGCTGC -> TCATCTCGGCCCTGCTGCA
ATCCAGGCCCCTGCACTTA -> TCCAGGCCCCTGCACTTAT
ATCCATGCGTGTTCACTCC -> TCCATGCGTGTTCACTCCG
ATCCCCGTAACAGATACAT -> TCCCCGTAACAGATACATG
ATCCGGCGCGCGAGCCGTC -> TCCGGCGCGCGAGCCGTCA
ATCCTGAGTGAATACACGA -> TCCTGAGTGAATACACGAG
ATCGATGGGGCCAAGTTGG -> TCGATGGGGCCAAGTTGGA
ATCGCAAATTCTGGACATG -> TCGCAAATTCTGGACATGC
ATCGCTGCTCCGGGCGCGG -> TCGCTGCTCCGGGCGCGGT
ATCGGCTGATAGTGCTATT -> TCGGCTGATAGTGCTATTT
ATCGGCTTCGCGTTATGAC -> TCGGCTTCGCGTTATGACT
ATCGGGCGTCAAAGTGCTG -> TCGGGCGTCAAAGTGCTGG
ATCGTAAAATTAACGCGTT -> TCGTAAAATTAACGCGTTG
ATCGTAACGTCTATACCTG -> TCGTAACGTCTATACCTGC
ATCGTAATTTTGAGTAGGG -> TCGTAATTTTGAGTAGGGA
ATCGTAGAAACAAGCCCCG -> TCGTAGAAACAAGCCCCGA
ATCTCGGCCCTGCTGCAGC -> TCTCGGCCCTGCTGCAGCT
ATCTCGTAGCCCTAACGAG -> TCTCGTAGCCCTAACGAGC
ATCTTACCACCCCAACGCT -> TCTTACCACCCCAACGCTC
ATCTTAGACAGGCTATGGG -> TCTTAGACAGGCTATGGGG
ATCTTCCTTCAAGCTCGAA -> TCTTCCTTCAAGCTCGAAC
ATCTTTCACAAGTCGTTGC -> TCTTTCACAAGTCGTTGCC
ATGAAAGCATTATTAGATG -> TGAAAGCATTATTAGATGG
ATGAAAGGCTTGCCCAACC -> TGAAAGGCTTGCCCAACCC
ATGAACATGGGGCCTCTCG -> TGAACATGGGGCCTCTCGT
ATGAAGCCGAAACTTATCT -> TGAAGCCGAAACTTATCTT
ATGAAGCCTGATGCACCGC -> TGAAGCCTGATGCACCGCT
ATGACACTTATCGGCTTCG -> TGACACTTATCGGCTTCGC
ATGACGATCCCCGTAACAG -> TGACGATCCCCGTAACAGA
ATGACTTACTACAACGTCA -> TGACTTACTACAACGTCAT
ATGAGTCTGCTGGACATGC -> TGAGTCTGCTGGACATGCA
ATGATCAGTGGCACTGAGA -> TGATCAGTGGCACTGAGAT
ATGATCCAGGCCCCTGCAC -> TGATCCAGGCCCCTGCACT
ATGATCCTGAGTGAATACA -> TGATCCTGAGTGAATACAC
ATGATGATCAGTGGCACTG -> TGATGATCAGTGGCACTGA
ATGATGCCCCAAGTTGGGA -> TGATGCCCCAAGTTGGGAA
ATGATGCCGAATCAGCAGT -> TGATGCCGAATCAGCAGTG
ATGATGGCTTACCAACCCG -> TGATGGCTTACCAACCCGG
ATGATTTACGACCGATGTA -> TGATTTACGACCGATGTAT
ATGCACACTGTCAATGTGA -> TGCACACTGTCAATGTGAG
ATGCACACTGTCCGATTTG -> TGCACACTGTCCGATTTGC
ATGCACACTGTCGAATTCC -> TGCACACTGTCGAATTCCA
ATGCACACTGTCTTGCGTG -> TGCACACTGTCTTGCGTGA
ATGCACCGCTCGAAAGACG -> TGCACCGCTCGAAAGACGA
ATGCATACAGATGGGCGGT -> TGCATACAGATGGGCGGTA
ATGCATACCATGGATTGTA -> TGCATACCATGGATTGTAC
ATGCCCCAAGTTGGGAACA -> TGCCCCAAGTTGGGAACAG
ATGCCGAATCAGCAGTGGT -> TGCCGAATCAGCAGTGGTT
ATGCGCACCCTTATCGGGC -> TGCGCACCCTTATCGGGCG
ATGCGCACGATGACACTTA -> TGCGCACGATGACACTTAT
ATGCGCCTCGGAATGATTT -> TGCGCCTCGGAATGATTTA
ATGCGTATTTAATATTATG -> TGCGTATTTAATATTATGT
ATGCGTGTTCACTCCGGTG -> TGCGTGTTCACTCCGGTGA
ATGCTAGTCAAGAATTGTG -> TGCTAGTCAAGAATTGTGC
ATGCTGTGGCTGGAATGCT -> TGCTGTGGCTGGAATGCTA
ATGGAGCCTAGTAAAACAA -> TGGAGCCTAGTAAAACAAA
ATGGAGGCAGGGTGCAAAC -> TGGAGGCAGGGTGCAAACC
ATGGAGTTCATACTTCTCC -> TGGAGTTCATACTTCTCCA
ATGGATTCGTCCTCCGCTG -> TGGATTCGTCCTCCGCTGC
ATGGATTGTACTGGGCCCC -> TGGATTGTACTGGGCCCCA
ATGGCGCTGCACACGTCTC -> TGGCGCTGCACACGTCTCC
ATGGCTTACCAACCCGGAC -> TGGCTTACCAACCCGGACA
ATGGCTTTCGCATGCGTAT -> TGGCTTTCGCATGCGTATT
ATGGGCGGTAATAACGTTG -> TGGGCGGTAATAACGTTGC
ATGGGGATATTGACTGTAT -> TGGGGATATTGACTGTATT
ATGGGGCCAAGTTGGACTT -> TGGGGCCAAGTTGGACTTA
ATGGGGCCTCTCGTTAGTT -> TGGGGCCTCTCGTTAGTTA
ATGTATCACGGGGCATAAT -> TGTATCACGGGGCATAATC
ATGTGACGGACACCTTGTA -> TGTGACGGACACCTTGTAG
ATGTGAGGCGCCGACATTA -> TGTGAGGCGCCGACATTAG
ATGTGATCGTAAAATTAAC -> TGTGATCGTAAAATTAACG
ATGTGCACACGTCTGTGCC -> TGTGCACACGTCTGTGCCA
ATGTGCGACTTATTCGACA -> TGTGCGACTTATTCGACAT
ATGTGTGAGAAGTGGCTGG -> TGTGTGAGAAGTGGCTGGA
ATGTTCTTGGCAAGCCACA -> TGTTCTTGGCAAGCCACAA
ATGTTTTGGTTCCGCACAT -> TGTTTTGGTTCCGCACATC
ATTAAACTTCGAAGAAAAC -> TTAAACTTCGAAGAAAACC
ATTAACGCGTTGAGGTCTC -> TTAACGCGTTGAGGTCTCT
ATTAAGCTGCTCCTATGAT -> TTAAGCTGCTCCTATGATG
ATTACATCGTAATTTTGAG -> TTACATCGTAATTTTGAGT
ATTACATGCATACCATGGA -> TTACATGCATACCATGGAT
ATTAGAACATGAGTCTGCT -> TTAGAACATGAGTCTGCTG
ATTAGATGGAGTTCATACT -> TTAGATGGAGTTCATACTT
ATTAGGTGTGTTTGGAAGT -> TTAGGTGTGTTTGGAAGTT
ATTAGGTGTGTTTGGAGGT -> TTAGGTGTGTTTGGAGGTT
ATTAGGTGTGTTTGTCGTA -> TTAGGTGTGTTTGTCGTAA
ATTAGGTGTGTTTGTGAGG -> TTAGGTGTGTTTGTGAGGC
ATTAGTGAGCATGTGACGG -> TTAGTGAGCATGTGACGGA
ATTATACGGTACACTATGT -> TTATACGGTACACTATGTG
ATTATGTGATCGTAAAATT -> TTATGTGATCGTAAAATTA
ATTATTAGATGGAGTTCAT -> TTATTAGATGGAGTTCATA
ATTCATATTACATGCATAC -> TTCATATTACATGCATACC
ATTCATGTGCACACGTCTG -> TTCATGTGCACACGTCTGT
ATTCCATCACCGACATTAG -> TTCCATCACCGACATTAGG
ATTCCCGATCACACGCACG -> TTCCCGATCACACGCACGA
ATTCGACACCGCGTTCGAC -> TTCGACACCGCGTTCGACC
ATTCGACATGATGCCCCAA -> TTCGACATGATGCCCCAAG
ATTCGAGCCACCCTCCTTT -> TTCGAGCCACCCTCCTTTA
ATTCGGTTTTTCATAAGCC -> TTCGGTTTTTCATAAGCCC
ATTCGTCCTCCGCTGCCCG -> TTCGTCCTCCGCTGCCCGT
ATTCTCAAGGGGGTGCCCT -> TTCTCAAGGGGGTGCCCTC
ATTCTGCGGGCTCTAACAT -> TTCTGCGGGCTCTAACATC
ATTCTGGACATGCACACTG -> TTCTGGACATGCACACTGT
ATTGACCAGATGCGCACGA -> TTGACCAGATGCGCACGAT
ATTGACTGTATTCGAGCCA -> TTGACTGTATTCGAGCCAC
ATTGAGTAATGAAGCCTGA -> TTGAGTAATGAAGCCTGAT
ATTGTACTGGGCCCCAAGC -> TTGTACTGGGCCCCAAGCG
ATTGTGCGCCTACCATGAT -> TTGTGCGCCTACCATGATC
ATTGTGCGCGAGACATACA -> TTGTGCGCGAGACATACAT
ATTTAATATTATGTGATCG -> TTTAATATTATGTGATCGT
ATTTACGACCGATGTATCA -> TTTACGACCGATGTATCAC
ATTTATGATGATCAGTGGC -> TTTATGATGATCAGTGGCA
ATTTGCAGTCCGACATTAG -> TTTGCAGTCCGACATTAGG
ATTTGTCCGTCCGTCCTAG -> TTTGTCCGTCCGTCCTAGT
ATTTTCCTGGACATGCACA -> TTTTCCTGGACATGCACAC
ATTTTGAGTAGGGAACTAA -> TTTTGAGTAGGGAACTAAT
ATTTTTCTCGTCTACACCC -> TTTTTCTCGTCTACACCCA
CAAAAGGGACGGTTCGGAT -> AAAAGGGACGGTTCGGATT
CAAACCAGATGGAGCCTAG -> AAACCAGATGGAGCCTAGT
CAAACTGGTTTCCTGGTGG -> AAACTGGTTTCCTGGTGGT
CAAAGGAGATTCATGTGCA -> AAAGGAGATTCATGTGCAC
CAAAGTGCTGGCGCACGTC -> AAAGTGCTGGCGCACGTCG
CAAATTCCCGATCACACGC -> AAATTCCCGATCACACGCA
CAAATTCGACACCGCGTTC -> AAATTCGACACCGCGTTCG
CAAATTCTGGACATGCACA -> AAATTCTGGACATGCACAC
CAACACATTGAGTAATGAA -> AACACATTGAGTAATGAAG
CAACCACGCGATTTGTCCG -> AACCACGCGATTTGTCCGT
CAACCCGGACATGGAGGCA -> AACCCGGACATGGAGGCAG
CAACCCTAACTGGATGAAC -> AACCCTAACTGGATGAACA
CAACGCACACGGCGGGGGA -> AACGCACACGGCGGGGGAA
CAACGCTCGACTAACCCTA -> AACGCTCGACTAACCCTAC
CAACGTCATCGGCTGATAG -> AACGTCATCGGCTGATAGT
CAACTAGTTTCGTTCTAAC -> AACTAGTTTCGTTCTAACG
CAACTGGCGGTACTTGTCA -> AACTGGCGGTACTTGTCAG
CAAGAATTGTGCGCGAGAC -> AAGAATTGTGCGCGAGACA
CAAGCCACAACTGGCGGTA -> AAGCCACAACTGGCGGTAC
CAAGCCACAGGGCAGTCCT -> AAGCCACAGGGCAGTCCTG
CAAGCCCCGAACGTTGCCC -> AAGCCCCGAACGTTGCCCA
CAAGCGTTGGAAAAAAGTC -> AAGCGTTGGAAAAAAGTCT
CAAGCTCGAACTAGCAATG -> AAGCTCGAACTAGCAATGA
CAAGGGGGTGCCCTCTAAT -> AAGGGGGTGCCCTCTAATA
CAAGTCGTTGCCTCCGCGG -> AAGTCGTTGCCTCCGCGGA
CAAGTTGGACTTACAGGGT -> AAGTTGGACTTACAGGGTC
CAAGTTGGGAACAGAAATG -> AAGTTGGGAACAGAAATGC
CAATGATCCAGGCCCCTGC -> AATGATCCAGGCCCCTGCA
CAATGTGAGGCGCCGACAT -> AATGTGAGGCGCCGACATT
CAATTAGAACATGAGTCTG -> AATTAGAACATGAGTCTGC
CAATTCTGCGGGCTCTAAC -> AATTCTGCGGGCTCTAACA
CACAACTGGCGGTACTTGT -> ACAACTGGCGGTACTTGTC
CACAAGTCGTTGCCTCCGC -> ACAAGTCGTTGCCTCCGCG
CACACGCACGAGTATGCAT -> ACACGCACGAGTATGCATA
CACACGGCGGGGGAAAAAA -> ACACGGCGGGGGAAAAAAA
CACACGTCTCCCTATGACG -> ACACGTCTCCCTATGACGA
CACACGTCTGTGCCACATG -> ACACGTCTGTGCCACATGA
CACACTGTCAATGTGAGGC -> ACACTGTCAATGTGAGGCG
CACACTGTCCGATTTGCAG -> ACACTGTCCGATTTGCAGT
CACACTGTCGAATTCCATC -> ACACTGTCGAATTCCATCA
CACACTGTCTTGCGTGAGT -> ACACTGTCTTGCGTGAGTC
CACAGCAGCCTTAAGCGCG -> ACAGCAGCCTTAAGCGCGC
CACAGGGCAGTCCTGCAAA -> ACAGGGCAGTCCTGCAAAG
CACATCATCTCGGCCCTGC -> ACATCATCTCGGCCCTGCT
CACATGATGGCTTACCAAC -> ACATGATGGCTTACCAACC
CACATTGAGTAATGAAGCC -> ACATTGAGTAATGAAGCCT
CACCAATTCTGCGGGCTCT -> ACCAATTCTGCGGGCTCTA
CACCATGCGCACCCTTATC -> ACCATGCGCACCCTTATCG
CACCCAACACATTGAGTAA -> ACCCAACACATTGAGTAAT
CACCCCAACGCTCGACTAA -> ACCCCAACGCTCGACTAAC
CACCCTCCTTTATACAACT -> ACCCTCCTTTATACAACTA
CACCCTTATCGGGCGTCAA -> ACCCTTATCGGGCGTCAAA
CACCGACATTAGGTGTGTT -> ACCGACATTAGGTGTGTTT
CACCGCGTTCGACCTCAGG -> ACCGCGTTCGACCTCAGGC
CACCGCTCGAAAGACGATG -> ACCGCTCGAAAGACGATGC
CACCTTGTAGCGTGCGATC -> ACCTTGTAGCGTGCGATCA
CACGAGGATCGCTGCTCCG -> ACGAGGATCGCTGCTCCGG
CACGAGTATGCATACAGAT -> ACGAGTATGCATACAGATG
CACGATCTCGTAGCCCTAA -> ACGATCTCGTAGCCCTAAC
CACGATGACACTTATCGGC -> ACGATGACACTTATCGGCT
CACGCACGAGTATGCATAC -> ACGCACGAGTATGCATACA
CACGCGATTTGTCCGTCCG -> ACGCGATTTGTCCGTCCGT
CACGGCGGGGGAAAAAAAG -> ACGGCGGGGGAAAAAAAGT
CACGGGGCATAATCGATGG -> ACGGGGCATAATCGATGGG
CACGGTCAGTCTAATCGCA -> ACGGTCAGTCTAATCGCAA
CACGTAGTCTCGGGGATCT -> ACGTAGTCTCGGGGATCTT
CACGTCACTCACGTAGTCT -> ACGTCACTCACGTAGTCTC
CACGTCGGTGCTTATCTTC -> ACGTCGGTGCTTATCTTCC
CACGTCTCCCTATGACGAT -> ACGTCTCCCTATGACGATC
CACGTCTGTGCCACATGAT -> ACGTCTGTGCCACATGATG
CACGTGCATGTTCTTGGCA -> ACGTGCATGTTCTTGGCAA
CACTATGTGCGACTTATTC -> ACTATGTGCGACTTATTCG
CACTCACGTAGTCTCGGGG -> ACTCACGTAGTCTCGGGGA
CACTCCGGTGAGAATTACA -> ACTCCGGTGAGAATTACAT
CACTGAGATAACTGATGGC -> ACTGAGATAACTGATGGCG
CACTGTCAATGTGAGGCGC -> ACTGTCAATGTGAGGCGCC
CACTGTCCGATTTGCAGTC -> ACTGTCCGATTTGCAGTCC
CACTGTCGAATTCCATCAC -> ACTGTCGAATTCCATCACC
CACTGTCTTGCGTGAGTCC -> ACTGTCTTGCGTGAGTCCC
CACTTATCGGCTTCGCGTT -> ACTTATCGGCTTCGCGTTA
CACTTATGAAGCCGAAACT -> ACTTATGAAGCCGAAACTT
CAGAAATGCGCCTCGGAAT -> AGAAATGCGCCTCGGAATG
CAGAAATTCGGTTTTTCAT -> AGAAATTCGGTTTTTCATA
CAGATACATGTTTTGGTTC -> AGATACATGTTTTGGTTCC
CAGATGAAAGCATTATTAG -> AGATGAAAGCATTATTAGA
CAGATGCGCACGATGACAC -> AGATGCGCACGATGACACT
CAGATGGAGCCTAGTAAAA -> AGATGGAGCCTAGTAAAAC
CAGATGGGCGGTAATAACG -> AGATGGGCGGTAATAACGT
CAGCAGCCTTAAGCGCGCC -> AGCAGCCTTAAGCGCGCCG
CAGCAGTGGTTACGTTGTC -> AGCAGTGGTTACGTTGTCG
CAGCCTTAAGCGCGCCGAT -> AGCCTTAAGCGCGCCGATT
CAGCGCGCCTGTGGGTGAC -> AGCGCGCCTGTGGGTGACG
CAGCGGAACCTGGGGAGAC -> AGCGGAACCTGGGGAGACA
CAGCTGTCCGGAGTCTCAG -> AGCTGTCCGGAGTCTCAGC
CAGGCCCCTGCACTTATGA -> AGGCCCCTGCACTTATGAA
CAGGCCTACCTGTCAAACT -> AGGCCTACCTGTCAAACTG
CAGGCGAAAACCCCATTGT -> AGGCGAAAACCCCATTGTG
CAGGCTATGGGGATATTGA -> AGGCTATGGGGATATTGAC
CAGGGCAGTCCTGCAAAGA -> AGGGCAGTCCTGCAAAGAT
CAGGGTCCAAATTCCCGAT -> AGGGTCCAAATTCCCGATC
CAGGGTGCAAACCAGATGG -> AGGGTGCAAACCAGATGGA
CAGGTCTTTTACGCCCCAA -> AGGTCTTTTACGCCCCAAC
CAGTACAGGTCTTTTACGC -> AGTACAGGTCTTTTACGCC
CAGTCCGACATTAGGTGTG -> AGTCCGACATTAGGTGTGT
CAGTCTAATCGCAAATTCT -> AGTCTAATCGCAAATTCTG
CAGTGCCTGACTCACGGTC -> AGTGCCTGACTCACGGTCA
CAGTGGCACTGAGATAACT -> AGTGGCACTGAGATAACTG
CAGTGGTTACGTTGTCGCT -> AGTGGTTACGTTGTCGCTC
CATAAGCCCGCCCATGAAA -> ATAAGCCCGCCCATGAAAG
CATAATCGATGGGGCCAAG -> ATAATCGATGGGGCCAAGT
CATACAGATGGGCGGTAAT -> ATACAGATGGGCGGTAATA
CATACATTAAACTTCGAAG -> ATACATTAAACTTCGAAGA
CATACCATGGATTGTACTG -> ATACCATGGATTGTACTGG
CATACTTCTCCACAGCAGC -> ATACTTCTCCACAGCAGCC
CATATTACATGCATACCAT -> ATATTACATGCATACCATG
CATCAAAGGAGATTCATGT -> ATCAAAGGAGATTCATGTG
CATCACCGACATTAGGTGT -> ATCACCGACATTAGGTGTG
CATCACGATCTCGTAGCCC -> ATCACGATCTCGTAGCCCT
CATCATCTCGGCCCTGCTG -> ATCATCTCGGCCCTGCTGC
CATCCGGCGCGCGAGCCGT -> ATCCGGCGCGCGAGCCGTC
CATCGGCTGATAGTGCTAT -> ATCGGCTGATAGTGCTATT
CATCGTAATTTTGAGTAGG -> ATCGTAATTTTGAGTAGGG
CATCTCGGCCCTGCTGCAG -> ATCTCGGCCCTGCTGCAGC
CATCTTACCACCCCAACGC -> ATCTTACCACCCCAACGCT
CATGAAAGGCTTGCCCAAC -> ATGAAAGGCTTGCCCAACC
CATGAGTCTGCTGGACATG -> ATGAGTCTGCTGGACATGC
CATGATCCTGAGTGAATAC -> ATGATCCTGAGTGAATACA
CATGATGCCCCAAGTTGGG -> ATGATGCCCCAAGTTGGGA
CATGATGGCTTACCAACCC -> ATGATGGCTTACCAACCCG
CATGCACACTGTCAATGTG -> ATGCACACTGTCAATGTGA
CATGCACACTGTCCGATTT -> ATGCACACTGTCCGATTTG
CATGCACACTGTCGAATTC -> ATGCACACTGTCGAATTCC
CATGCACACTGTCTTGCGT -> ATGCACACTGTCTTGCGTG
CATGCATACCATGGATTGT -> ATGCATACCATGGATTGTA
CATGCGCACCCTTATCGGG -> ATGCGCACCCTTATCGGGC
CATGCGTATTTAATATTAT -> ATGCGTATTTAATATTATG
CATGCGTGTTCACTCCGGT -> ATGCGTGTTCACTCCGGTG
CATGGAGGCAGGGTGCAAA -> ATGGAGGCAGGGTGCAAAC
CATGGATTGTACTGGGCCC -> ATGGATTGTACTGGGCCCC
CATGGGGCCTCTCGTTAGT -> ATGGGGCCTCTCGTTAGTT
CATGTGACGGACACCTTGT -> ATGTGACGGACACCTTGTA
CATGTGCACACGTCTGTGC -> ATGTGCACACGTCTGTGCC
CATGTTCTTGGCAAGCCAC -> ATGTTCTTGGCAAGCCACA
CATGTTTTGGTTCCGCACA -> ATGTTTTGGTTCCGCACAT
CATTAAACTTCGAAGAAAA -> ATTAAACTTCGAAGAAAAC
CATTAGGTGTGTTTGGAAG -> ATTAGGTGTGTTTGGAAGT
CATTAGGTGTGTTTGGAGG -> ATTAGGTGTGTTTGGAGGT
CATTAGGTGTGTTTGTCGT -> ATTAGGTGTGTTTGTCGTA
CATTAGGTGTGTTTGTGAG -> ATTAGGTGTGTTTGTGAGG
CATTATTAGATGGAGTTCA -> ATTATTAGATGGAGTTCAT
CATTGACCAGATGCGCACG -> ATTGACCAGATGCGCACGA
CATTGAGTAATGAAGCCTG -> ATTGAGTAATGAAGCCTGA
CATTGTGCGCCTACCATGA -> ATTGTGCGCCTACCATGAT
CATTTTCCTGGACATGCAC -> ATTTTCCTGGACATGCACA
CCAAATTCCCGATCACACG -> CAAATTCCCGATCACACGC
CCAACACATTGAGTAATGA -> CAACACATTGAGTAATGAA
CCAACCACGCGATTTGTCC -> CAACCACGCGATTTGTCCG
CCAACCCGGACATGGAGGC -> CAACCCGGACATGGAGGCA
CCAACCCTAACTGGATGAA -> CAACCCTAACTGGATGAAC
CCAACGCTCGACTAACCCT -> CAACGCTCGACTAACCCTA
CCAAGCGTTGGAAAAAAGT -> CAAGCGTTGGAAAAAAGTC
CCAAGTTGGACTTACAGGG -> CAAGTTGGACTTACAGGGT
CCAAGTTGGGAACAGAAAT -> CAAGTTGGGAACAGAAATG
CCAATTCTGCGGGCTCTAA -> CAATTCTGCGGGCTCTAAC
CCACAACTGGCGGTACTTG -> CACAACTGGCGGTACTTGT
CCACAGCAGCCTTAAGCGC -> CACAGCAGCCTTAAGCGCG
CCACAGGGCAGTCCTGCAA -> CACAGGGCAGTCCTGCAAA
CCACATGATGGCTTACCAA -> CACATGATGGCTTACCAAC
CCACCAATTCTGCGGGCTC -> CACCAATTCTGCGGGCTCT
CCACCCCAACGCTCGACTA -> CACCCCAACGCTCGACTAA
CCACCCTCCTTTATACAAC -> CACCCTCCTTTATACAACT
CCACGCGATTTGTCCGTCC -> CACGCGATTTGTCCGTCCG
CCACGTGCATGTTCTTGGC -> CACGTGCATGTTCTTGGCA
CCAGATGAAAGCATTATTA -> CAGATGAAAGCATTATTAG
CCAGATGCGCACGATGACA -> CAGATGCGCACGATGACAC
CCAGATGGAGCCTAGTAAA -> CAGATGGAGCCTAGTAAAA
CCAGGCCCCTGCACTTATG -> CAGGCCCCTGCACTTATGA
CCATCACCGACATTAGGTG -> CATCACCGACATTAGGTGT
CCATCCGGCGCGCGAGCCG -> CATCCGGCGCGCGAGCCGT
CCATGAAAGGCTTGCCCAA -> CATGAAAGGCTTGCCCAAC
CCATGATCCTGAGTGAATA -> CATGATCCTGAGTGAATAC
CCATGCGCACCCTTATCGG -> CATGCGCACCCTTATCGGG
CCATGCGTGTTCACTCCGG -> CATGCGTGTTCACTCCGGT
CCATGGATTGTACTGGGCC -> CATGGATTGTACTGGGCCC
CCATTGTGCGCCTACCATG -> CATTGTGCGCCTACCATGA
CCATTTTCCTGGACATGCA -> CATTTTCCTGGACATGCAC
CCCAACACATTGAGTAATG -> CCAACACATTGAGTAATGA
CCCAACCACGCGATTTGTC -> CCAACCACGCGATTTGTCC
CCCAACCCTAACTGGATGA -> CCAACCCTAACTGGATGAA
CCCAACGCTCGACTAACCC -> CCAACGCTCGACTAACCCT
CCCAAGCGTTGGAAAAAAG -> CCAAGCGTTGGAAAAAAGT
CCCAAGTTGGGAACAGAAA -> CCAAGTTGGGAACAGAAAT
CCCACGTGCATGTTCTTGG -> CCACGTGCATGTTCTTGGC
CCCAGATGAAAGCATTATT -> CCAGATGAAAGCATTATTA
CCCATCCGGCGCGCGAGCC -> CCATCCGGCGCGCGAGCCG
CCCATGAAAGGCTTGCCCA -> CCATGAAAGGCTTGCCCAA
CCCATTGTGCGCCTACCAT -> CCATTGTGCGCCTACCATG
CCCCAACCACGCGATTTGT -> CCCAACCACGCGATTTGTC
CCCCAACGCTCGACTAACC -> CCCAACGCTCGACTAACCC
CCCCAAGCGTTGGAAAAAA -> CCCAAGCGTTGGAAAAAAG
CCCCAAGTTGGGAACAGAA -> CCCAAGTTGGGAACAGAAA
CCCCATTGTGCGCCTACCA -> CCCATTGTGCGCCTACCAT
CCCCGAACGTTGCCCATCC -> CCCGAACGTTGCCCATCCG
CCCCGTAACAGATACATGT -> CCCGTAACAGATACATGTT
CCCCTGCACTTATGAAGCC -> CCCTGCACTTATGAAGCCG
CCCGAACGTTGCCCATCCG -> CCGAACGTTGCCCATCCGG
CCCGACATTAGGTGTGTTT -> CCGACATTAGGTGTGTTTG
CCCGATCACACGCACGAGT -> CCGATCACACGCACGAGTA
CCCGCCCATGAAAGGCTTG -> CCGCCCATGAAAGGCTTGC
CCCGGACATGGAGGCAGGG -> CCGGACATGGAGGCAGGGT
CCCGTAACAGATACATGTT -> CCGTAACAGATACATGTTT
CCCGTCACGTCACTCACGT -> CCGTCACGTCACTCACGTA
CCCTAACGAGCGGAATAAA -> CCTAACGAGCGGAATAAAA
CCCTAACTGGATGAACATG -> CCTAACTGGATGAACATGG
CCCTACCACCAATTCTGCG -> CCTACCACCAATTCTGCGG
CCCTATGACGATCCCCGTA -> CCTATGACGATCCCCGTAA
CCCTCCTTTATACAACTAG -> CCTCCTTTATACAACTAGT
CCCTCTAATACCCAGATGA -> CCTCTAATACCCAGATGAA
CCCTGCACTTATGAAGCCG -> CCTGCACTTATGAAGCCGA
CCCTGCTGCAGCTGTCCGG -> CCTGCTGCAGCTGTCCGGA
CCCTTATCGGGCGTCAAAG -> CCTTATCGGGCGTCAAAGT
CCCTTGCTAGACGAACGTA -> CCTTGCTAGACGAACGTAG
CCGAAACTTATCTTTCACA -> CGAAACTTATCTTTCACAA
CCGAACGTTGCCCATCCGG -> CGAACGTTGCCCATCCGGC
CCGAATCAGCAGTGGTTAC -> CGAATCAGCAGTGGTTACG
CCGACATTAGGTGTGTTTG -> CGACATTAGGTGTGTTTGG,CGACATTAGGTGTGTTTGG,CGACATTAGGTGTGTTTGT,CGACATTAGGTGTGTTTGT
CCGACTGGACATGCACACT -> CGACTGGACATGCACACTG
CCGAGTCAGGCGAAAACCC -> CGAGTCAGGCGAAAACCCC
CCGATCACACGCACGAGTA -> CGATCACACGCACGAGTAT
CCGATGTATCACGGGGCAT -> CGATGTATCACGGGGCATA
CCGATTAGTGAGCATGTGA -> CGATTAGTGAGCATGTGAC
CCGATTTGCAGTCCGACAT -> CGATTTGCAGTCCGACATT
CCGCACATCATCTCGGCCC -> CGCACATCATCTCGGCCCT
CCGCCCATGAAAGGCTTGC -> CGCCCATGAAAGGCTTGCC
CCGCGGAATTAAGCTGCTC -> CGCGGAATTAAGCTGCTCC
CCGCGTTCGACCTCAGGCC -> CGCGTTCGACCTCAGGCCT
CCGCTCGAAAGACGATGCT -> CGCTCGAAAGACGATGCTG
CCGCTGCCCGTCACGTCAC -> CGCTGCCCGTCACGTCACT
CCGGACATGGAGGCAGGGT -> CGGACATGGAGGCAGGGTG
CCGGAGTCTCAGCGGAACC -> CGGAGTCTCAGCGGAACCT
CCGGCGCGCGAGCCGTCAG -> CGGCGCGCGAGCCGTCAGA
CCGGGCGCGGTCATTGACC -> CGGGCGCGGTCATTGACCA
CCGGTGAGAATTACATCGT -> CGGTGAGAATTACATCGTA
CCGTAACAGATACATGTTT -> CGTAACAGATACATGTTTT
CCGTCACGTCACTCACGTA -> CGTCACGTCACTCACGTAG
CCGTCAGAAATTCGGTTTT -> CGTCAGAAATTCGGTTTTT
CCGTCCGTCCTAGTGGTAT -> CGTCCGTCCTAGTGGTATT
CCGTCCTAGTGGTATTCAT -> CGTCCTAGTGGTATTCATA
CCGTTAAGCATCACGATCT -> CGTTAAGCATCACGATCTC
CCTAACGAGCGGAATAAAA -> CTAACGAGCGGAATAAAAA
CCTAACTCACCATGCGCAC -> CTAACTCACCATGCGCACC
CCTAACTGGATGAACATGG -> CTAACTGGATGAACATGGG
CCTACCACCAATTCTGCGG -> CTACCACCAATTCTGCGGG
CCTACCATGATCCTGAGTG -> CTACCATGATCCTGAGTGA
CCTACCTGTCAAACTGGTT -> CTACCTGTCAAACTGGTTT
CCTAGTAAAACAAATTCGA -> CTAGTAAAACAAATTCGAC
CCTAGTGGTATTCATATTA -> CTAGTGGTATTCATATTAC
CCTATGACGATCCCCGTAA -> CTATGACGATCCCCGTAAC
CCTATGATGCCGAATCAGC -> CTATGATGCCGAATCAGCA
CCTCAGGCCTACCTGTCAA -> CTCAGGCCTACCTGTCAAA
CCTCCGCGGAATTAAGCTG -> CTCCGCGGAATTAAGCTGC
CCTCCGCTGCCCGTCACGT -> CTCCGCTGCCCGTCACGTC
CCTCCTTTATACAACTAGT -> CTCCTTTATACAACTAGTT
CCTCGGAATGATTTACGAC -> CTCGGAATGATTTACGACC
CCTCTAATACCCAGATGAA -> CTCTAATACCCAGATGAAA
CCTCTCGTTAGTTACTCAT -> CTCTCGTTAGTTACTCATC
CCTCTGCAATTAGAACATG -> CTCTGCAATTAGAACATGA
CCTGACTCACGGTCAGTCT -> CTGACTCACGGTCAGTCTA
CCTGAGTGAATACACGAGG -> CTGAGTGAATACACGAGGA
CCTGATGCACCGCTCGAAA -> CTGATGCACCGCTCGAAAG
CCTGCACTTATGAAGCCGA -> CTGCACTTATGAAGCCGAA
CCTGCTGAAGTCTAATGGC -> CTGCTGAAGTCTAATGGCT
CCTGCTGCAGCTGTCCGGA -> CTGCTGCAGCTGTCCGGAG
CCTGGACATGCACACTGTC -> CTGGACATGCACACTGTCC
CCTGGGGAGACAGCGCGCC -> CTGGGGAGACAGCGCGCCT
CCTGGTGGTATACGATTTT -> CTGGTGGTATACGATTTTT
CCTGTCAAACTGGTTTCCT -> CTGTCAAACTGGTTTCCTG
CCTGTGGGTGACGACAGTA -> CTGTGGGTGACGACAGTAC
CCTTAAGCGCGCCGATTAG -> CTTAAGCGCGCCGATTAGT
CCTTATCGGGCGTCAAAGT -> CTTATCGGGCGTCAAAGTG
CCTTCAAGCTCGAACTAGC -> CTTCAAGCTCGAACTAGCA
CCTTGCTAGACGAACGTAG -> CTTGCTAGACGAACGTAGA
CCTTGTAGCGTGCGATCAA -> CTTGTAGCGTGCGATCAAC
CCTTTATACAACTAGTTTC -> CTTTATACAACTAGTTTCG
CGAAAACCCCATTGTGCGC -> GAAAACCCCATTGTGCGCC
CGAAACTTATCTTTCACAA -> GAAACTTATCTTTCACAAG
CGAAAGACGATGCTGTGGC -> GAAAGACGATGCTGTGGCT
CGAACGTAGACCATTTTCC -> GAACGTAGACCATTTTCCT
CGAACGTTGCCCATCCGGC -> GAACGTTGCCCATCCGGCG
CGAACTAGCAATGATCCAG -> GAACTAGCAATGATCCAGG
CGAAGAAAACCTAACTCAC -> GAAGAAAACCTAACTCACC
CGAATCAGCAGTGGTTACG -> GAATCAGCAGTGGTTACGT
CGAATTCCATCACCGACAT -> GAATTCCATCACCGACATT
CGAATTCTCAAGGGGGTGC -> GAATTCTCAAGGGGGTGCC
CGACACCGCGTTCGACCTC -> GACACCGCGTTCGACCTCA
CGACAGTACAGGTCTTTTA -> GACAGTACAGGTCTTTTAC
CGACATGATGCCCCAAGTT -> GACATGATGCCCCAAGTTG
CGACATTAGGTGTGTTTGG -> GACATTAGGTGTGTTTGGA,GACATTAGGTGTGTTTGGA
CGACATTAGGTGTGTTTGT -> GACATTAGGTGTGTTTGTC,GACATTAGGTGTGTTTGTG
CGACCCTTGCTAGACGAAC -> GACCCTTGCTAGACGAACG
CGACCGATGTATCACGGGG -> GACCGATGTATCACGGGGC
CGACCTCAGGCCTACCTGT -> GACCTCAGGCCTACCTGTC
CGACTAACCCTACCACCAA -> GACTAACCCTACCACCAAT
CGACTGGACATGCACACTG -> GACTGGACATGCACACTGT
CGACTTATTCGACATGATG -> GACTTATTCGACATGATGC
CGAGACATACATTAAACTT -> GAGACATACATTAAACTTC
CGAGCCACCCTCCTTTATA -> GAGCCACCCTCCTTTATAC
CGAGCCGTCAGAAATTCGG -> GAGCCGTCAGAAATTCGGT
CGAGCGGAATAAAAACCCA -> GAGCGGAATAAAAACCCAC
CGAGGATCGCTGCTCCGGG -> GAGGATCGCTGCTCCGGGC
CGAGTATGCATACAGATGG -> GAGTATGCATACAGATGGG
CGAGTCAGGCGAAAACCCC -> GAGTCAGGCGAAAACCCCA
CGATCAACGCACACGGCGG -> GATCAACGCACACGGCGGG
CGATCACACGCACGAGTAT -> GATCACACGCACGAGTATG
CGATCCCCGTAACAGATAC -> GATCCCCGTAACAGATACA
CGATCTCGTAGCCCTAACG -> GATCTCGTAGCCCTAACGA
CGATGACACTTATCGGCTT -> GATGACACTTATCGGCTTC
CGATGCTGTGGCTGGAATG -> GATGCTGTGGCTGGAATGC
CGATGGGGCCAAGTTGGAC -> GATGGGGCCAAGTTGGACT
CGATGTATCACGGGGCATA -> GATGTATCACGGGGCATAA
CGATTAGTGAGCATGTGAC -> GATTAGTGAGCATGTGACG
CGATTTGCAGTCCGACATT -> GATTTGCAGTCCGACATTA
CGATTTGTCCGTCCGTCCT -> GATTTGTCCGTCCGTCCTA
CGATTTTTCTCGTCTACAC -> GATTTTTCTCGTCTACACC
CGCAAATTCTGGACATGCA -> GCAAATTCTGGACATGCAC
CGCACACGGCGGGGGAAAA -> GCACACGGCGGGGGAAAAA
CGCACATCATCTCGGCCCT -> GCACATCATCTCGGCCCTG
CGCACCCTTATCGGGCGTC -> GCACCCTTATCGGGCGTCA
CGCACGAGTATGCATACAG -> GCACGAGTATGCATACAGA
CGCACGATGACACTTATCG -> GCACGATGACACTTATCGG
CGCACGTCGGTGCTTATCT -> GCACGTCGGTGCTTATCTT
CGCATGCGTATTTAATATT -> GCATGCGTATTTAATATTA
CGCCCATGAAAGGCTTGCC -> GCCCATGAAAGGCTTGCCC
CGCCCCAACCACGCGATTT -> GCCCCAACCACGCGATTTG
CGCCGACATTAGGTGTGTT -> GCCGACATTAGGTGTGTTT
CGCCGATTAGTGAGCATGT -> GCCGATTAGTGAGCATGTG
CGCCTACCATGATCCTGAG -> GCCTACCATGATCCTGAGT
CGCCTCGGAATGATTTACG -> GCCTCGGAATGATTTACGA
CGCCTGTGGGTGACGACAG -> GCCTGTGGGTGACGACAGT
CGCGAGACATACATTAAAC -> GCGAGACATACATTAAACT
CGCGAGCCGTCAGAAATTC -> GCGAGCCGTCAGAAATTCG
CGCGATTTGTCCGTCCGTC -> GCGATTTGTCCGTCCGTCC
CGCGCCGATTAGTGAGCAT -> GCGCCGATTAGTGAGCATG
CGCGCCTGTGGGTGACGAC -> GCGCCTGTGGGTGACGACA
CGCGCGAGCCGTCAGAAAT -> GCGCGAGCCGTCAGAAATT
CGCGGAATTAAGCTGCTCC -> GCGGAATTAAGCTGCTCCT
CGCGGTCATTGACCAGATG -> GCGGTCATTGACCAGATGC
CGCGTTATGACTTACTACA -> GCGTTATGACTTACTACAA
CGCGTTCGACCTCAGGCCT -> GCGTTCGACCTCAGGCCTA
CGCGTTGAGGTCTCTTGGC -> GCGTTGAGGTCTCTTGGCT
CGCTCCGAGTCAGGCGAAA -> GCTCCGAGTCAGGCGAAAA
CGCTCGAAAGACGATGCTG -> GCTCGAAAGACGATGCTGT
CGCTCGACTAACCCTACCA -> GCTCGACTAACCCTACCAC
CGCTGCACACGTCTCCCTA -> GCTGCACACGTCTCCCTAT
CGCTGCCCGTCACGTCACT -> GCTGCCCGTCACGTCACTC
CGCTGCTCCGGGCGCGGTC -> GCTGCTCCGGGCGCGGTCA
CGGAACCTGGGGAGACAGC -> GGAACCTGGGGAGACAGCG
CGGAATAAAAACCCACGTG -> GGAATAAAAACCCACGTGC
CGGAATGATTTACGACCGA -> GGAATGATTTACGACCGAT
CGGAATTAAGCTGCTCCTA -> GGAATTAAGCTGCTCCTAT
CGGACACCTTGTAGCGTGC -> GGACACCTTGTAGCGTGCG
CGGACATGGAGGCAGGGTG -> GGACATGGAGGCAGGGTGC
CGGAGTCTCAGCGGAACCT -> GGAGTCTCAGCGGAACCTG
CGGATGGATTCGTCCTCCG -> GGATGGATTCGTCCTCCGC
CGGATTATACGGTACACTA -> GGATTATACGGTACACTAT
CGGCCCTGCTGCAGCTGTC -> GGCCCTGCTGCAGCTGTCC
CGGCGCGCGAGCCGTCAGA -> GGCGCGCGAGCCGTCAGAA
CGGCGGGGGAAAAAAAGTG -> GGCGGGGGAAAAAAAGTGC
CGGCTGATAGTGCTATTTA -> GGCTGATAGTGCTATTTAT
CGGCTTCGCGTTATGACTT -> GGCTTCGCGTTATGACTTA
CGGGCGCGGTCATTGACCA -> GGGCGCGGTCATTGACCAG
CGGGCGTCAAAGTGCTGGC -> GGGCGTCAAAGTGCTGGCG
CGGGCTCTAACATCAAAGG -> GGGCTCTAACATCAAAGGA
CGGGGATCTTAGACAGGCT -> GGGGATCTTAGACAGGCTA
CGGGGCATAATCGATGGGG -> GGGGCATAATCGATGGGGC
CGGGGGAAAAAAAGTGCCT -> GGGGGAAAAAAAGTGCCTC
CGGTAATAACGTTGCCGAC -> GGTAATAACGTTGCCGACT
CGGTACACTATGTGCGACT -> GGTACACTATGTGCGACTT
CGGTACTTGTCAGTGCCTG -> GGTACTTGTCAGTGCCTGA
CGGTCAGTCTAATCGCAAA -> GGTCAGTCTAATCGCAAAT
CGGTCATTGACCAGATGCG -> GGTCATTGACCAGATGCGC
CGGTGAGAATTACATCGTA -> GGTGAGAATTACATCGTAA
CGGTGCTTATCTTCCTTCA -> GGTGCTTATCTTCCTTCAA
CGGTTCGGATTATACGGTA -> GGTTCGGATTATACGGTAC
CGGTTTTTCATAAGCCCGC -> GGTTTTTCATAAGCCCGCC
CGTAAAATTAACGCGTTGA -> GTAAAATTAACGCGTTGAG
CGTAACAGATACATGTTTT -> GTAACAGATACATGTTTTG
CGTAACGACCCTTGCTAGA -> GTAACGACCCTTGCTAGAC
CGTAACGTCTATACCTGCT -> GTAACGTCTATACCTGCTG
CGTAATTTTGAGTAGGGAA -> GTAATTTTGAGTAGGGAAC
CGTAGAAACAAGCCCCGAA -> GTAGAAACAAGCCCCGAAC
CGTAGACCATTTTCCTGGA -> GTAGACCATTTTCCTGGAC
CGTAGCCCTAACGAGCGGA -> GTAGCCCTAACGAGCGGAA
CGTAGTCTCGGGGATCTTA -> GTAGTCTCGGGGATCTTAG
CGTATTTAATATTATGTGA -> GTATTTAATATTATGTGAT
CGTCAAAGTGCTGGCGCAC -> GTCAAAGTGCTGGCGCACG
CGTCACGTCACTCACGTAG -> GTCACGTCACTCACGTAGT
CGTCACTCACGTAGTCTCG -> GTCACTCACGTAGTCTCGG
CGTCAGAAATTCGGTTTTT -> GTCAGAAATTCGGTTTTTC
CGTCATCGGCTGATAGTGC -> GTCATCGGCTGATAGTGCT
CGTCCGTCCTAGTGGTATT -> GTCCGTCCTAGTGGTATTC
CGTCCTAGTGGTATTCATA -> GTCCTAGTGGTATTCATAT
CGTCCTCCGCTGCCCGTCA -> GTCCTCCGCTGCCCGTCAC
CGTCGGTGCTTATCTTCCT -> GTCGGTGCTTATCTTCCTT
CGTCTACACCCAACACATT -> GTCTACACCCAACACATTG
CGTCTATACCTGCTGAAGT -> GTCTATACCTGCTGAAGTC
CGTCTCCCTATGACGATCC -> GTCTCCCTATGACGATCCC
CGTCTGTGCCACATGATGG -> GTCTGTGCCACATGATGGC
CGTGAGTCCCGACATTAGG -> GTGAGTCCCGACATTAGGT
CGTGCATGTTCTTGGCAAG -> GTGCATGTTCTTGGCAAGC
CGTGCGATCAACGCACACG -> GTGCGATCAACGCACACGG
CGTGTTCACTCCGGTGAGA -> GTGTTCACTCCGGTGAGAA
CGTGTTTATGTGTGAGAAG -> GTGTTTATGTGTGAGAAGT
CGTTAAGCATCACGATCTC -> GTTAAGCATCACGATCTCG
CGTTAGTTACTCATCTTAC -> GTTAGTTACTCATCTTACC
CGTTATGACTTACTACAAC -> GTTATGACTTACTACAACG
CGTTCGACCTCAGGCCTAC -> GTTCGACCTCAGGCCTACC
CGTTCTAACGAATTCTCAA -> GTTCTAACGAATTCTCAAG
CGTTGAGGTCTCTTGGCTG -> GTTGAGGTCTCTTGGCTGC
CGTTGCCCATCCGGCGCGC -> GTTGCCCATCCGGCGCGCG
CGTTGCCGACTGGACATGC -> GTTGCCGACTGGACATGCA
CGTTGCCTCCGCGGAATTA -> GTTGCCTCCGCGGAATTAA
CGTTGGAAAAAAGTCTACA -> GTTGGAAAAAAGTCTACAA
CGTTGTCGCTCCGAGTCAG -> GTTGTCGCTCCGAGTCAGG
CTAACATCAAAGGAGATTC -> TAACATCAAAGGAGATTCA
CTAACCCTACCACCAATTC -> TAACCCTACCACCAATTCT
CTAACGAATTCTCAAGGGG -> TAACGAATTCTCAAGGGGG
CTAACGAGCGGAATAAAAA -> TAACGAGCGGAATAAAAAC
CTAACTCACCATGCGCACC -> TAACTCACCATGCGCACCC
CTAACTGGATGAACATGGG -> TAACTGGATGAACATGGGG
CTAATACCCAGATGAAAGC -> TAATACCCAGATGAAAGCA
CTAATCGCAAATTCTGGAC -> TAATCGCAAATTCTGGACA
CTAATCGTAGAAACAAGCC -> TAATCGTAGAAACAAGCCC
CTAATGGCTTTCGCATGCG -> TAATGGCTTTCGCATGCGT
CTACAACGTCATCGGCTGA -> TACAACGTCATCGGCTGAT
CTACAAGCCACAGGGCAGT -> TACAAGCCACAGGGCAGTC
CTACACCCAACACATTGAG -> TACACCCAACACATTGAGT
CTACCACCAATTCTGCGGG -> TACCACCAATTCTGCGGGC
CTACCATGATCCTGAGTGA -> TACCATGATCCTGAGTGAA
CTACCTGTCAAACTGGTTT -> TACCTGTCAAACTGGTTTC
CTAGACGAACGTAGACCAT -> TAGACGAACGTAGACCATT
CTAGCAATGATCCAGGCCC -> TAGCAATGATCCAGGCCCC
CTAGCCGTTAAGCATCACG -> TAGCCGTTAAGCATCACGA
CTAGTAAAACAAATTCGAC -> TAGTAAAACAAATTCGACA
CTAGTCAAGAATTGTGCGC -> TAGTCAAGAATTGTGCGCG
CTAGTGGTATTCATATTAC -> TAGTGGTATTCATATTACA
CTAGTTTCGTTCTAACGAA -> TAGTTTCGTTCTAACGAAT
CTATACCTGCTGAAGTCTA -> TATACCTGCTGAAGTCTAA
CTATGACGATCCCCGTAAC -> TATGACGATCCCCGTAACA
CTATGATGCCGAATCAGCA -> TATGATGCCGAATCAGCAG
CTATGGGGATATTGACTGT -> TATGGGGATATTGACTGTA
CTATGTGCGACTTATTCGA -> TATGTGCGACTTATTCGAC
CTATTTATGATGATCAGTG -> TATTTATGATGATCAGTGG
CTCAAGGGGGTGCCCTCTA -> TCAAGGGGGTGCCCTCTAA
CTCACCATGCGCACCCTTA -> TCACCATGCGCACCCTTAT
CTCACGGTCAGTCTAATCG -> TCACGGTCAGTCTAATCGC
CTCACGTAGTCTCGGGGAT -> TCACGTAGTCTCGGGGATC
CTCAGCGGAACCTGGGGAG -> TCAGCGGAACCTGGGGAGA
CTCAGGCCTACCTGTCAAA -> TCAGGCCTACCTGTCAAAC
CTCATCTTACCACCCCAAC -> TCATCTTACCACCCCAACG
CTCCACAGCAGCCTTAAGC -> TCCACAGCAGCCTTAAGCG
CTCCCTATGACGATCCCCG -> TCCCTATGACGATCCCCGT
CTCCGAGTCAGGCGAAAAC -> TCCGAGTCAGGCGAAAACC
CTCCGCGGAATTAAGCTGC -> TCCGCGGAATTAAGCTGCT
CTCCGCTGCCCGTCACGTC -> TCCGCTGCCCGTCACGTCA
CTCCGGGCGCGGTCATTGA -> TCCGGGCGCGGTCATTGAC
CTCCGGTGAGAATTACATC -> TCCGGTGAGAATTACATCG
CTCCTATGATGCCGAATCA -> TCCTATGATGCCGAATCAG
CTCCTTTATACAACTAGTT -> TCCTTTATACAACTAGTTT
CTCGAAAGACGATGCTGTG -> TCGAAAGACGATGCTGTGG
CTCGAACTAGCAATGATCC -> TCGAACTAGCAATGATCCA
CTCGACTAACCCTACCACC -> TCGACTAACCCTACCACCA
CTCGGAATGATTTACGACC -> TCGGAATGATTTACGACCG
CTCGGCCCTGCTGCAGCTG -> TCGGCCCTGCTGCAGCTGT
CTCGGGGATCTTAGACAGG -> TCGGGGATCTTAGACAGGC
CTCGTAGCCCTAACGAGCG -> TCGTAGCCCTAACGAGCGG
CTCGTCTACACCCAACACA -> TCGTCTACACCCAACACAT
CTCGTTAGTTACTCATCTT -> TCGTTAGTTACTCATCTTA
CTCTAACATCAAAGGAGAT -> TCTAACATCAAAGGAGATT
CTCTAATACCCAGATGAAA -> TCTAATACCCAGATGAAAG
CTCTCGTTAGTTACTCATC -> TCTCGTTAGTTACTCATCT
CTCTGCAATTAGAACATGA -> TCTGCAATTAGAACATGAG
CTCTTGGCTGCGGATGGAT -> TCTTGGCTGCGGATGGATT
CTGAAGTCTAATGGCTTTC -> TGAAGTCTAATGGCTTTCG
CTGACTCACGGTCAGTCTA -> TGACTCACGGTCAGTCTAA
CTGAGATAACTGATGGCGC -> TGAGATAACTGATGGCGCT
CTGAGTGAATACACGAGGA -> TGAGTGAATACACGAGGAT
CTGATAGTGCTATTTATGA -> TGATAGTGCTATTTATGAT
CTGATGCACCGCTCGAAAG -> TGATGCACCGCTCGAAAGA
CTGATGGCGCTGCACACGT -> TGATGGCGCTGCACACGTC
CTGCAATTAGAACATGAGT -> TGCAATTAGAACATGAGTC
CTGCACACGTCTCCCTATG -> TGCACACGTCTCCCTATGA
CTGCACTTATGAAGCCGAA -> TGCACTTATGAAGCCGAAA
CTGCAGCTGTCCGGAGTCT -> TGCAGCTGTCCGGAGTCTC
CTGCCCGTCACGTCACTCA -> TGCCCGTCACGTCACTCAC
CTGCGGATGGATTCGTCCT -> TGCGGATGGATTCGTCCTC
CTGCGGGCTCTAACATCAA -> TGCGGGCTCTAACATCAAA
CTGCTCCGGGCGCGGTCAT -> TGCTCCGGGCGCGGTCATT
CTGCTCCTATGATGCCGAA -> TGCTCCTATGATGCCGAAT
CTGCTGAAGTCTAATGGCT -> TGCTGAAGTCTAATGGCTT
CTGCTGCAGCTGTCCGGAG -> TGCTGCAGCTGTCCGGAGT
CTGCTGGACATGCACACTG -> TGCTGGACATGCACACTGT
CTGGAATGCTAGTCAAGAA -> TGGAATGCTAGTCAAGAAT
CTGGACAAAAGGGACGGTT -> TGGACAAAAGGGACGGTTC
CTGGACATGCACACTGTCA -> TGGACATGCACACTGTCAA
CTGGACATGCACACTGTCC -> TGGACATGCACACTGTCCG
CTGGACATGCACACTGTCG -> TGGACATGCACACTGTCGA
CTGGACATGCACACTGTCT -> TGGACATGCACACTGTCTT
CTGGATGAACATGGGGCCT -> TGGATGAACATGGGGCCTC
CTGGCGCACGTCGGTGCTT -> TGGCGCACGTCGGTGCTTA
CTGGCGGTACTTGTCAGTG -> TGGCGGTACTTGTCAGTGC
CTGGGCCCCAAGCGTTGGA -> TGGGCCCCAAGCGTTGGAA
CTGGGGAGACAGCGCGCCT -> TGGGGAGACAGCGCGCCTG
CTGGTGGTATACGATTTTT -> TGGTGGTATACGATTTTTC
CTGGTTTCCTGGTGGTATA -> TGGTTTCCTGGTGGTATAC
CTGTATTCGAGCCACCCTC -> TGTATTCGAGCCACCCTCC
CTGTCAAACTGGTTTCCTG -> TGTCAAACTGGTTTCCTGG
CTGTCAATGTGAGGCGCCG -> TGTCAATGTGAGGCGCCGA
CTGTCCGATTTGCAGTCCG -> TGTCCGATTTGCAGTCCGA
CTGTCCGGAGTCTCAGCGG -> TGTCCGGAGTCTCAGCGGA
CTGTCGAATTCCATCACCG -> TGTCGAATTCCATCACCGA
CTGTCTTGCGTGAGTCCCG -> TGTCTTGCGTGAGTCCCGA
CTGTGCCACATGATGGCTT -> TGTGCCACATGATGGCTTA
CTGTGGCTGGAATGCTAGT -> TGTGGCTGGAATGCTAGTC
CTGTGGGTGACGACAGTAC -> TGTGGGTGACGACAGTACA
CTTAAGCGCGCCGATTAGT -> TTAAGCGCGCCGATTAGTG
CTTACAGGGTCCAAATTCC -> TTACAGGGTCCAAATTCCC
CTTACCAACCCGGACATGG -> TTACCAACCCGGACATGGA
CTTACCACCCCAACGCTCG -> TTACCACCCCAACGCTCGA
CTTACTACAACGTCATCGG -> TTACTACAACGTCATCGGC
CTTAGACAGGCTATGGGGA -> TTAGACAGGCTATGGGGAT
CTTATCGGCTTCGCGTTAT -> TTATCGGCTTCGCGTTATG
CTTATCGGGCGTCAAAGTG -> TTATCGGGCGTCAAAGTGC
CTTATCTTCCTTCAAGCTC -> TTATCTTCCTTCAAGCTCG
CTTATCTTTCACAAGTCGT -> TTATCTTTCACAAGTCGTT
CTTATGAAGCCGAAACTTA -> TTATGAAGCCGAAACTTAT
CTTATTCGACATGATGCCC -> TTATTCGACATGATGCCCC
CTTCAAGCTCGAACTAGCA -> TTCAAGCTCGAACTAGCAA
CTTCCTTCAAGCTCGAACT -> TTCCTTCAAGCTCGAACTA
CTTCGAAGAAAACCTAACT -> TTCGAAGAAAACCTAACTC
CTTCGCGTTATGACTTACT -> TTCGCGTTATGACTTACTA
CTTCTCCACAGCAGCCTTA -> TTCTCCACAGCAGCCTTAA
CTTGCCCAACCCTAACTGG -> TTGCCCAACCCTAACTGGA
CTTGCGTGAGTCCCGACAT -> TTGCGTGAGTCCCGACATT
CTTGCTAGACGAACGTAGA -> TTGCTAGACGAACGTAGAC
CTTGGCAAGCCACAACTGG -> TTGGCAAGCCACAACTGGC
CTTGGCTGCGGATGGATTC -> TTGGCTGCGGATGGATTCG
CTTGTAGCGTGCGATCAAC -> TTGTAGCGTGCGATCAACG
CTTGTCAGTGCCTGACTCA -> TTGTCAGTGCCTGACTCAC
CTTTATACAACTAGTTTCG -> TTTATACAACTAGTTTCGT
CTTTCACAAGTCGTTGCCT -> TTTCACAAGTCGTTGCCTC
CTTTCGCATGCGTATTTAA -> TTTCGCATGCGTATTTAAT
CTTTTACGCCCCAACCACG -> TTTTACGCCCCAACCACGC
GAAAAAAAGTGCCTCTGCA -> AAAAAAAGTGCCTCTGCAA
GAAAAAAGTCTACAAGCCA -> AAAAAAGTCTACAAGCCAC
GAAAACCCCATTGTGCGCC -> AAAACCCCATTGTGCGCCT
GAAAACCTAACTCACCATG -> AAAACCTAACTCACCATGC
GAAACAAGCCCCGAACGTT -> AAACAAGCCCCGAACGTTG
GAAACTTATCTTTCACAAG -> AAACTTATCTTTCACAAGT
GAAAGACGATGCTGTGGCT -> AAAGACGATGCTGTGGCTG
GAAAGCATTATTAGATGGA -> AAAGCATTATTAGATGGAG
GAAAGGCTTGCCCAACCCT -> AAAGGCTTGCCCAACCCTA
GAAATGCGCCTCGGAATGA -> AAATGCGCCTCGGAATGAT
GAAATTCGGTTTTTCATAA -> AAATTCGGTTTTTCATAAG
GAACAGAAATGCGCCTCGG -> AACAGAAATGCGCCTCGGA
GAACATGAGTCTGCTGGAC -> AACATGAGTCTGCTGGACA
GAACATGGGGCCTCTCGTT -> AACATGGGGCCTCTCGTTA
GAACCTGGGGAGACAGCGC -> AACCTGGGGAGACAGCGCG
GAACGTAGACCATTTTCCT -> AACGTAGACCATTTTCCTG
GAACGTGTTTATGTGTGAG -> AACGTGTTTATGTGTGAGA
GAACGTTGCCCATCCGGCG -> AACGTTGCCCATCCGGCGC
GAACTAATCGTAGAAACAA -> AACTAATCGTAGAAACAAG
GAACTAGCAATGATCCAGG -> AACTAGCAATGATCCAGGC
GAAGAAAACCTAACTCACC -> AAGAAAACCTAACTCACCA
GAAGCCGAAACTTATCTTT -> AAGCCGAAACTTATCTTTC
GAAGCCTGATGCACCGCTC -> AAGCCTGATGCACCGCTCG
GAAGTCTAATGGCTTTCGC -> AAGTCTAATGGCTTTCGCA
GAAGTGGCTGGACAAAAGG -> AAGTGGCTGGACAAAAGGG
GAAGTTATCCATGCGTGTT -> AAGTTATCCATGCGTGTTC
GAATAAAAACCCACGTGCA -> AATAAAAACCCACGTGCAT
GAATACACGAGGATCGCTG -> AATACACGAGGATCGCTGC
GAATCAGCAGTGGTTACGT -> AATCAGCAGTGGTTACGTT
GAATGATTTACGACCGATG -> AATGATTTACGACCGATGT
GAATGCTAGTCAAGAATTG -> AATGCTAGTCAAGAATTGT
GAATTAAGCTGCTCCTATG -> AATTAAGCTGCTCCTATGA
GAATTACATCGTAATTTTG -> AATTACATCGTAATTTTGA
GAATTCCATCACCGACATT -> AATTCCATCACCGACATTA
GAATTCTCAAGGGGGTGCC -> AATTCTCAAGGGGGTGCCC
GAATTGTGCGCGAGACATA -> AATTGTGCGCGAGACATAC
GACAAAAGGGACGGTTCGG -> ACAAAAGGGACGGTTCGGA
GACACCGCGTTCGACCTCA -> ACACCGCGTTCGACCTCAG
GACACCTTGTAGCGTGCGA -> ACACCTTGTAGCGTGCGAT
GACACTTATCGGCTTCGCG -> ACACTTATCGGCTTCGCGT
GACAGCGCGCCTGTGGGTG -> ACAGCGCGCCTGTGGGTGA
GACAGGCTATGGGGATATT -> ACAGGCTATGGGGATATTG
GACAGTACAGGTCTTTTAC -> ACAGTACAGGTCTTTTACG
GACATACATTAAACTTCGA -> ACATACATTAAACTTCGAA
GACATGATGCCCCAAGTTG -> ACATGATGCCCCAAGTTGG
GACATGCACACTGTCAATG -> ACATGCACACTGTCAATGT
GACATGCACACTGTCCGAT -> ACATGCACACTGTCCGATT
GACATGCACACTGTCGAAT -> ACATGCACACTGTCGAATT
GACATGCACACTGTCTTGC -> ACATGCACACTGTCTTGCG
GACATGGAGGCAGGGTGCA -> ACATGGAGGCAGGGTGCAA
GACATTAGGTGTGTTTGGA -> ACATTAGGTGTGTTTGGAA,ACATTAGGTGTGTTTGGAG
GACATTAGGTGTGTTTGTC -> ACATTAGGTGTGTTTGTCG
GACATTAGGTGTGTTTGTG -> ACATTAGGTGTGTTTGTGA
GACCAGATGCGCACGATGA -> ACCAGATGCGCACGATGAC
GACCATTTTCCTGGACATG -> ACCATTTTCCTGGACATGC
GACCCTTGCTAGACGAACG -> ACCCTTGCTAGACGAACGT
GACCGATGTATCACGGGGC -> ACCGATGTATCACGGGGCA
GACCTCAGGCCTACCTGTC -> ACCTCAGGCCTACCTGTCA
GACGAACGTAGACCATTTT -> ACGAACGTAGACCATTTTC
GACGACAGTACAGGTCTTT -> ACGACAGTACAGGTCTTTT
GACGATCCCCGTAACAGAT -> ACGATCCCCGTAACAGATA
GACGATGCTGTGGCTGGAA -> ACGATGCTGTGGCTGGAAT
GACGGACACCTTGTAGCGT -> ACGGACACCTTGTAGCGTG
GACGGTTCGGATTATACGG -> ACGGTTCGGATTATACGGT
GACTAACCCTACCACCAAT -> ACTAACCCTACCACCAATT
GACTCACGGTCAGTCTAAT -> ACTCACGGTCAGTCTAATC
GACTGGACATGCACACTGT -> ACTGGACATGCACACTGTC
GACTGTATTCGAGCCACCC -> ACTGTATTCGAGCCACCCT
GACTTACAGGGTCCAAATT -> ACTTACAGGGTCCAAATTC
GACTTACTACAACGTCATC -> ACTTACTACAACGTCATCG
GACTTATTCGACATGATGC -> ACTTATTCGACATGATGCC
GAGAAGTGGCTGGACAAAA -> AGAAGTGGCTGGACAAAAG
GAGAATTACATCGTAATTT -> AGAATTACATCGTAATTTT
GAGACAGCGCGCCTGTGGG -> AGACAGCGCGCCTGTGGGT
GAGACATACATTAAACTTC -> AGACATACATTAAACTTCG
GAGATAACTGATGGCGCTG -> AGATAACTGATGGCGCTGC
GAGATTCATGTGCACACGT -> AGATTCATGTGCACACGTC
GAGCATGTGACGGACACCT -> AGCATGTGACGGACACCTT
GAGCCACCCTCCTTTATAC -> AGCCACCCTCCTTTATACA
GAGCCGTCAGAAATTCGGT -> AGCCGTCAGAAATTCGGTT
GAGCCTAGTAAAACAAATT -> AGCCTAGTAAAACAAATTC
GAGCGGAATAAAAACCCAC -> AGCGGAATAAAAACCCACG
GAGGATCGCTGCTCCGGGC -> AGGATCGCTGCTCCGGGCG
GAGGCAGGGTGCAAACCAG -> AGGCAGGGTGCAAACCAGA
GAGGCGCCGACATTAGGTG -> AGGCGCCGACATTAGGTGT
GAGGCTAGCCGTTAAGCAT -> AGGCTAGCCGTTAAGCATC
GAGGTCTCTTGGCTGCGGA -> AGGTCTCTTGGCTGCGGAT
GAGGTTGAACGTGTTTATG -> AGGTTGAACGTGTTTATGT
GAGTAATGAAGCCTGATGC -> AGTAATGAAGCCTGATGCA
GAGTAGGGAACTAATCGTA -> AGTAGGGAACTAATCGTAG
GAGTATGCATACAGATGGG -> AGTATGCATACAGATGGGC
GAGTCAGGCGAAAACCCCA -> AGTCAGGCGAAAACCCCAT
GAGTCCCGACATTAGGTGT -> AGTCCCGACATTAGGTGTG
GAGTCTCAGCGGAACCTGG -> AGTCTCAGCGGAACCTGGG
GAGTCTGCTGGACATGCAC -> AGTCTGCTGGACATGCACA
GAGTGAATACACGAGGATC -> AGTGAATACACGAGGATCG
GAGTTCATACTTCTCCACA -> AGTTCATACTTCTCCACAG
GATAACTGATGGCGCTGCA -> ATAACTGATGGCGCTGCAC
GATACATGTTTTGGTTCCG -> ATACATGTTTTGGTTCCGC
GATAGTGCTATTTATGATG -> ATAGTGCTATTTATGATGA
GATATTGACTGTATTCGAG -> ATATTGACTGTATTCGAGC
GATCAACGCACACGGCGGG -> ATCAACGCACACGGCGGGG
GATCACACGCACGAGTATG -> ATCACACGCACGAGTATGC
GATCAGTGGCACTGAGATA -> ATCAGTGGCACTGAGATAA
GATCCAGGCCCCTGCACTT -> ATCCAGGCCCCTGCACTTA
GATCCCCGTAACAGATACA -> ATCCCCGTAACAGATACAT
GATCCTGAGTGAATACACG -> ATCCTGAGTGAATACACGA
GATCGCTGCTCCGGGCGCG -> ATCGCTGCTCCGGGCGCGG
GATCGTAAAATTAACGCGT -> ATCGTAAAATTAACGCGTT
GATCTCGTAGCCCTAACGA -> ATCTCGTAGCCCTAACGAG
GATCTTAGACAGGCTATGG -> ATCTTAGACAGGCTATGGG
GATGAAAGCATTATTAGAT -> ATGAAAGCATTATTAGATG
GATGAACATGGGGCCTCTC -> ATGAACATGGGGCCTCTCG
GATGACACTTATCGGCTTC -> ATGACACTTATCGGCTTCG
GATGATCAGTGGCACTGAG -> ATGATCAGTGGCACTGAGA
GATGCACCGCTCGAAAGAC -> ATGCACCGCTCGAAAGACG
GATGCCCCAAGTTGGGAAC -> ATGCCCCAAGTTGGGAACA
GATGCCGAATCAGCAGTGG -> ATGCCGAATCAGCAGTGGT
GATGCGCACGATGACACTT -> ATGCGCACGATGACACTTA
GATGCTGTGGCTGGAATGC -> ATGCTGTGGCTGGAATGCT
GATGGAGCCTAGTAAAACA -> ATGGAGCCTAGTAAAACAA
GATGGAGTTCATACTTCTC -> ATGGAGTTCATACTTCTCC
GATGGATTCGTCCTCCGCT -> ATGGATTCGTCCTCCGCTG
GATGGCGCTGCACACGTCT -> ATGGCGCTGCACACGTCTC
GATGGCTTACCAACCCGGA -> ATGGCTTACCAACCCGGAC
GATGGGCGGTAATAACGTT -> ATGGGCGGTAATAACGTTG
GATGGGGCCAAGTTGGACT -> ATGGGGCCAAGTTGGACTT
GATGTATCACGGGGCATAA -> ATGTATCACGGGGCATAAT
GATTAGTGAGCATGTGACG -> ATTAGTGAGCATGTGACGG
GATTATACGGTACACTATG -> ATTATACGGTACACTATGT
GATTCATGTGCACACGTCT -> ATTCATGTGCACACGTCTG
GATTCGTCCTCCGCTGCCC -> ATTCGTCCTCCGCTGCCCG
GATTGTACTGGGCCCCAAG -> ATTGTACTGGGCCCCAAGC
GATTTACGACCGATGTATC -> ATTTACGACCGATGTATCA
GATTTGCAGTCCGACATTA -> ATTTGCAGTCCGACATTAG
GATTTGTCCGTCCGTCCTA -> ATTTGTCCGTCCGTCCTAG
GATTTTTCTCGTCTACACC -> ATTTTTCTCGTCTACACCC
GCAAACCAGATGGAGCCTA -> CAAACCAGATGGAGCCTAG
GCAAATTCTGGACATGCAC -> CAAATTCTGGACATGCACA
GCAAGCCACAACTGGCGGT -> CAAGCCACAACTGGCGGTA
GCAATGATCCAGGCCCCTG -> CAATGATCCAGGCCCCTGC
GCAATTAGAACATGAGTCT -> CAATTAGAACATGAGTCTG
GCACACGGCGGGGGAAAAA -> CACACGGCGGGGGAAAAAA
GCACACGTCTCCCTATGAC -> CACACGTCTCCCTATGACG
GCACACGTCTGTGCCACAT -> CACACGTCTGTGCCACATG
GCACACTGTCAATGTGAGG -> CACACTGTCAATGTGAGGC
GCACACTGTCCGATTTGCA -> CACACTGTCCGATTTGCAG
GCACACTGTCGAATTCCAT -> CACACTGTCGAATTCCATC
GCACACTGTCTTGCGTGAG -> CACACTGTCTTGCGTGAGT
GCACATCATCTCGGCCCTG -> CACATCATCTCGGCCCTGC
GCACCCTTATCGGGCGTCA -> CACCCTTATCGGGCGTCAA
GCACCGCTCGAAAGACGAT -> CACCGCTCGAAAGACGATG
GCACGAGTATGCATACAGA -> CACGAGTATGCATACAGAT
GCACGATGACACTTATCGG -> CACGATGACACTTATCGGC
GCACGTCGGTGCTTATCTT -> CACGTCGGTGCTTATCTTC
GCACTGAGATAACTGATGG -> CACTGAGATAACTGATGGC
GCACTTATGAAGCCGAAAC -> CACTTATGAAGCCGAAACT
GCAGCCTTAAGCGCGCCGA -> CAGCCTTAAGCGCGCCGAT
GCAGCTGTCCGGAGTCTCA -> CAGCTGTCCGGAGTCTCAG
GCAGGGTGCAAACCAGATG -> CAGGGTGCAAACCAGATGG
GCAGTCCGACATTAGGTGT -> CAGTCCGACATTAGGTGTG
GCAGTGGTTACGTTGTCGC -> CAGTGGTTACGTTGTCGCT
GCATAATCGATGGGGCCAA -> CATAATCGATGGGGCCAAG
GCATACAGATGGGCGGTAA -> CATACAGATGGGCGGTAAT
GCATACCATGGATTGTACT -> CATACCATGGATTGTACTG
GCATCACGATCTCGTAGCC -> CATCACGATCTCGTAGCCC
GCATGCGTATTTAATATTA -> CATGCGTATTTAATATTAT
GCATGTGACGGACACCTTG -> CATGTGACGGACACCTTGT
GCATGTTCTTGGCAAGCCA -> CATGTTCTTGGCAAGCCAC
GCATTATTAGATGGAGTTC -> CATTATTAGATGGAGTTCA
GCCAAGTTGGACTTACAGG -> CCAAGTTGGACTTACAGGG
GCCACAACTGGCGGTACTT -> CCACAACTGGCGGTACTTG
GCCACAGGGCAGTCCTGCA -> CCACAGGGCAGTCCTGCAA
GCCACATGATGGCTTACCA -> CCACATGATGGCTTACCAA
GCCACCCTCCTTTATACAA -> CCACCCTCCTTTATACAAC
GCCCAACCCTAACTGGATG -> CCCAACCCTAACTGGATGA
GCCCATCCGGCGCGCGAGC -> CCCATCCGGCGCGCGAGCC
GCCCATGAAAGGCTTGCCC -> CCCATGAAAGGCTTGCCCA
GCCCCAACCACGCGATTTG -> CCCCAACCACGCGATTTGT
GCCCCAAGCGTTGGAAAAA -> CCCCAAGCGTTGGAAAAAA
GCCCCAAGTTGGGAACAGA -> CCCCAAGTTGGGAACAGAA
GCCCCGAACGTTGCCCATC -> CCCCGAACGTTGCCCATCC
GCCCCTGCACTTATGAAGC -> CCCCTGCACTTATGAAGCC
GCCCGCCCATGAAAGGCTT -> CCCGCCCATGAAAGGCTTG
GCCCGTCACGTCACTCACG -> CCCGTCACGTCACTCACGT
GCCCTAACGAGCGGAATAA -> CCCTAACGAGCGGAATAAA
GCCCTCTAATACCCAGATG -> CCCTCTAATACCCAGATGA
GCCCTGCTGCAGCTGTCCG -> CCCTGCTGCAGCTGTCCGG
GCCGAAACTTATCTTTCAC -> CCGAAACTTATCTTTCACA
GCCGAATCAGCAGTGGTTA -> CCGAATCAGCAGTGGTTAC
GCCGACATTAGGTGTGTTT -> CCGACATTAGGTGTGTTTG
GCCGACTGGACATGCACAC -> CCGACTGGACATGCACACT
GCCGATTAGTGAGCATGTG -> CCGATTAGTGAGCATGTGA
GCCGTCAGAAATTCGGTTT -> CCGTCAGAAATTCGGTTTT
GCCGTTAAGCATCACGATC -> CCGTTAAGCATCACGATCT
GCCTACCATGATCCTGAGT -> CCTACCATGATCCTGAGTG
GCCTACCTGTCAAACTGGT -> CCTACCTGTCAAACTGGTT
GCCTAGTAAAACAAATTCG -> CCTAGTAAAACAAATTCGA
GCCTCCGCGGAATTAAGCT -> CCTCCGCGGAATTAAGCTG
GCCTCGGAATGATTTACGA -> CCTCGGAATGATTTACGAC
GCCTCTCGTTAGTTACTCA -> CCTCTCGTTAGTTACTCAT
GCCTCTGCAATTAGAACAT -> CCTCTGCAATTAGAACATG
GCCTGACTCACGGTCAGTC -> CCTGACTCACGGTCAGTCT
GCCTGATGCACCGCTCGAA -> CCTGATGCACCGCTCGAAA
GCCTGTGGGTGACGACAGT -> CCTGTGGGTGACGACAGTA
GCCTTAAGCGCGCCGATTA -> CCTTAAGCGCGCCGATTAG
GCGAAAACCCCATTGTGCG -> CGAAAACCCCATTGTGCGC
GCGACTTATTCGACATGAT -> CGACTTATTCGACATGATG
GCGAGACATACATTAAACT -> CGAGACATACATTAAACTT
GCGAGCCGTCAGAAATTCG -> CGAGCCGTCAGAAATTCGG
GCGATCAACGCACACGGCG -> CGATCAACGCACACGGCGG
GCGATTTGTCCGTCCGTCC -> CGATTTGTCCGTCCGTCCT
GCGCACCCTTATCGGGCGT -> CGCACCCTTATCGGGCGTC
GCGCACGATGACACTTATC -> CGCACGATGACACTTATCG
GCGCACGTCGGTGCTTATC -> CGCACGTCGGTGCTTATCT
GCGCCGACATTAGGTGTGT -> CGCCGACATTAGGTGTGTT
GCGCCGATTAGTGAGCATG -> CGCCGATTAGTGAGCATGT
GCGCCTACCATGATCCTGA -> CGCCTACCATGATCCTGAG
GCGCCTCGGAATGATTTAC -> CGCCTCGGAATGATTTACG
GCGCCTGTGGGTGACGACA -> CGCCTGTGGGTGACGACAG
GCGCGAGACATACATTAAA -> CGCGAGACATACATTAAAC
GCGCGAGCCGTCAGAAATT -> CGCGAGCCGTCAGAAATTC
GCGCGCCGATTAGTGAGCA -> CGCGCCGATTAGTGAGCAT
GCGCGCCTGTGGGTGACGA -> CGCGCCTGTGGGTGACGAC
GCGCGCGAGCCGTCAGAAA -> CGCGCGAGCCGTCAGAAAT
GCGCGGTCATTGACCAGAT -> CGCGGTCATTGACCAGATG
GCGCTGCACACGTCTCCCT -> CGCTGCACACGTCTCCCTA
GCGGAACCTGGGGAGACAG -> CGGAACCTGGGGAGACAGC
GCGGAATAAAAACCCACGT -> CGGAATAAAAACCCACGTG
GCGGAATTAAGCTGCTCCT -> CGGAATTAAGCTGCTCCTA
GCGGATGGATTCGTCCTCC -> CGGATGGATTCGTCCTCCG
GCGGGCTCTAACATCAAAG -> CGGGCTCTAACATCAAAGG
GCGGGGGAAAAAAAGTGCC -> CGGGGGAAAAAAAGTGCCT
GCGGTAATAACGTTGCCGA -> CGGTAATAACGTTGCCGAC
GCGGTACTTGTCAGTGCCT -> CGGTACTTGTCAGTGCCTG
GCGGTCATTGACCAGATGC -> CGGTCATTGACCAGATGCG
GCGTATTTAATATTATGTG -> CGTATTTAATATTATGTGA
GCGTCAAAGTGCTGGCGCA -> CGTCAAAGTGCTGGCGCAC
GCGTGAGTCCCGACATTAG -> CGTGAGTCCCGACATTAGG
GCGTGCGATCAACGCACAC -> CGTGCGATCAACGCACACG
GCGTGTTCACTCCGGTGAG -> CGTGTTCACTCCGGTGAGA
GCGTTATGACTTACTACAA -> CGTTATGACTTACTACAAC
GCGTTCGACCTCAGGCCTA -> CGTTCGACCTCAGGCCTAC
GCGTTGAGGTCTCTTGGCT -> CGTTGAGGTCTCTTGGCTG
GCGTTGGAAAAAAGTCTAC -> CGTTGGAAAAAAGTCTACA
GCTAGACGAACGTAGACCA -> CTAGACGAACGTAGACCAT
GCTAGCCGTTAAGCATCAC -> CTAGCCGTTAAGCATCACG
GCTAGTCAAGAATTGTGCG -> CTAGTCAAGAATTGTGCGC
GCTATGGGGATATTGACTG -> CTATGGGGATATTGACTGT
GCTATTTATGATGATCAGT -> CTATTTATGATGATCAGTG
GCTCCGAGTCAGGCGAAAA -> CTCCGAGTCAGGCGAAAAC
GCTCCGGGCGCGGTCATTG -> CTCCGGGCGCGGTCATTGA
GCTCCTATGATGCCGAATC -> CTCCTATGATGCCGAATCA
GCTCGAAAGACGATGCTGT -> CTCGAAAGACGATGCTGTG
GCTCGAACTAGCAATGATC -> CTCGAACTAGCAATGATCC
GCTCGACTAACCCTACCAC -> CTCGACTAACCCTACCACC
GCTCTAACATCAAAGGAGA -> CTCTAACATCAAAGGAGAT
GCTGAAGTCTAATGGCTTT -> CTGAAGTCTAATGGCTTTC
GCTGATAGTGCTATTTATG -> CTGATAGTGCTATTTATGA
GCTGCACACGTCTCCCTAT -> CTGCACACGTCTCCCTATG
GCTGCAGCTGTCCGGAGTC -> CTGCAGCTGTCCGGAGTCT
GCTGCCCGTCACGTCACTC -> CTGCCCGTCACGTCACTCA
GCTGCGGATGGATTCGTCC -> CTGCGGATGGATTCGTCCT
GCTGCTCCGGGCGCGGTCA -> CTGCTCCGGGCGCGGTCAT
GCTGCTCCTATGATGCCGA -> CTGCTCCTATGATGCCGAA
GCTGGAATGCTAGTCAAGA -> CTGGAATGCTAGTCAAGAA
GCTGGACAAAAGGGACGGT -> CTGGACAAAAGGGACGGTT
GCTGGACATGCACACTGTC -> CTGGACATGCACACTGTCG
GCTGGCGCACGTCGGTGCT -> CTGGCGCACGTCGGTGCTT
GCTGTCCGGAGTCTCAGCG -> CTGTCCGGAGTCTCAGCGG
GCTGTGGCTGGAATGCTAG -> CTGTGGCTGGAATGCTAGT
GCTTACCAACCCGGACATG -> CTTACCAACCCGGACATGG
GCTTATCTTCCTTCAAGCT -> CTTATCTTCCTTCAAGCTC
GCTTCGCGTTATGACTTAC -> CTTCGCGTTATGACTTACT
GCTTGCCCAACCCTAACTG -> CTTGCCCAACCCTAACTGG
GCTTTCGCATGCGTATTTA -> CTTTCGCATGCGTATTTAA
GGAAAAAAAGTGCCTCTGC -> GAAAAAAAGTGCCTCTGCA
GGAAAAAAGTCTACAAGCC -> GAAAAAAGTCTACAAGCCA
GGAACAGAAATGCGCCTCG -> GAACAGAAATGCGCCTCGG
GGAACCTGGGGAGACAGCG -> GAACCTGGGGAGACAGCGC
GGAACTAATCGTAGAAACA -> GAACTAATCGTAGAAACAA
GGAAGTTATCCATGCGTGT -> GAAGTTATCCATGCGTGTT
GGAATAAAAACCCACGTGC -> GAATAAAAACCCACGTGCA
GGAATGATTTACGACCGAT -> GAATGATTTACGACCGATG
GGAATGCTAGTCAAGAATT -> GAATGCTAGTCAAGAATTG
GGAATTAAGCTGCTCCTAT -> GAATTAAGCTGCTCCTATG
GGACAAAAGGGACGGTTCG -> GACAAAAGGGACGGTTCGG
GGACACCTTGTAGCGTGCG -> GACACCTTGTAGCGTGCGA
GGACATGCACACTGTCAAT -> GACATGCACACTGTCAATG
GGACATGCACACTGTCCGA -> GACATGCACACTGTCCGAT
GGACATGCACACTGTCGAA -> GACATGCACACTGTCGAAT
GGACATGCACACTGTCTTG -> GACATGCACACTGTCTTGC
GGACATGGAGGCAGGGTGC -> GACATGGAGGCAGGGTGCA
GGACGGTTCGGATTATACG -> GACGGTTCGGATTATACGG
GGACTTACAGGGTCCAAAT -> GACTTACAGGGTCCAAATT
GGAGACAGCGCGCCTGTGG -> GAGACAGCGCGCCTGTGGG
GGAGATTCATGTGCACACG -> GAGATTCATGTGCACACGT
GGAGCCTAGTAAAACAAAT -> GAGCCTAGTAAAACAAATT
GGAGGCAGGGTGCAAACCA -> GAGGCAGGGTGCAAACCAG
GGAGGTTGAACGTGTTTAT -> GAGGTTGAACGTGTTTATG
GGAGTCTCAGCGGAACCTG -> GAGTCTCAGCGGAACCTGG
GGAGTTCATACTTCTCCAC -> GAGTTCATACTTCTCCACA
GGATATTGACTGTATTCGA -> GATATTGACTGTATTCGAG
GGATCGCTGCTCCGGGCGC -> GATCGCTGCTCCGGGCGCG
GGATCTTAGACAGGCTATG -> GATCTTAGACAGGCTATGG
GGATGAACATGGGGCCTCT -> GATGAACATGGGGCCTCTC
GGATGGATTCGTCCTCCGC -> GATGGATTCGTCCTCCGCT
GGATTATACGGTACACTAT -> GATTATACGGTACACTATG
GGATTCGTCCTCCGCTGCC -> GATTCGTCCTCCGCTGCCC
GGATTGTACTGGGCCCCAA -> GATTGTACTGGGCCCCAAG
GGCAAGCCACAACTGGCGG -> GCAAGCCACAACTGGCGGT
GGCACTGAGATAACTGATG -> GCACTGAGATAACTGATGG
GGCAGGGTGCAAACCAGAT -> GCAGGGTGCAAACCAGATG
GGCAGTCCTGCAAAGATTG -> GCAGTCCTGCAAAGATTGG
GGCATAATCGATGGGGCCA -> GCATAATCGATGGGGCCAA
GGCCAAGTTGGACTTACAG -> GCCAAGTTGGACTTACAGG
GGCCCCAAGCGTTGGAAAA -> GCCCCAAGCGTTGGAAAAA
GGCCCCTGCACTTATGAAG -> GCCCCTGCACTTATGAAGC
GGCCCTGCTGCAGCTGTCC -> GCCCTGCTGCAGCTGTCCG
GGCCTACCTGTCAAACTGG -> GCCTACCTGTCAAACTGGT
GGCCTCTCGTTAGTTACTC -> GCCTCTCGTTAGTTACTCA
GGCGAAAACCCCATTGTGC -> GCGAAAACCCCATTGTGCG
GGCGCACGTCGGTGCTTAT -> GCGCACGTCGGTGCTTATC
GGCGCCGACATTAGGTGTG -> GCGCCGACATTAGGTGTGT
GGCGCGCGAGCCGTCAGAA -> GCGCGCGAGCCGTCAGAAA
GGCGCGGTCATTGACCAGA -> GCGCGGTCATTGACCAGAT
GGCGCTGCACACGTCTCCC -> GCGCTGCACACGTCTCCCT
GGCGGGGGAAAAAAAGTGC -> GCGGGGGAAAAAAAGTGCC
GGCGGTAATAACGTTGCCG -> GCGGTAATAACGTTGCCGA
GGCGGTACTTGTCAGTGCC -> GCGGTACTTGTCAGTGCCT
GGCGTCAAAGTGCTGGCGC -> GCGTCAAAGTGCTGGCGCA
GGCTAGCCGTTAAGCATCA -> GCTAGCCGTTAAGCATCAC
GGCTATGGGGATATTGACT -> GCTATGGGGATATTGACTG
GGCTCTAACATCAAAGGAG -> GCTCTAACATCAAAGGAGA
GGCTGATAGTGCTATTTAT -> GCTGATAGTGCTATTTATG
GGCTGCGGATGGATTCGTC -> GCTGCGGATGGATTCGTCC
GGCTGGAATGCTAGTCAAG -> GCTGGAATGCTAGTCAAGA
GGCTGGACAAAAGGGACGG -> GCTGGACAAAAGGGACGGT
GGCTTACCAACCCGGACAT -> GCTTACCAACCCGGACATG
GGCTTCGCGTTATGACTTA -> GCTTCGCGTTATGACTTAC
GGCTTGCCCAACCCTAACT -> GCTTGCCCAACCCTAACTG
GGCTTTCGCATGCGTATTT -> GCTTTCGCATGCGTATTTA
GGGAAAAAAAGTGCCTCTG -> GGAAAAAAAGTGCCTCTGC
GGGAACAGAAATGCGCCTC -> GGAACAGAAATGCGCCTCG
GGGAACTAATCGTAGAAAC -> GGAACTAATCGTAGAAACA
GGGACGGTTCGGATTATAC -> GGACGGTTCGGATTATACG
GGGAGACAGCGCGCCTGTG -> GGAGACAGCGCGCCTGTGG
GGGATATTGACTGTATTCG -> GGATATTGACTGTATTCGA
GGGATCTTAGACAGGCTAT -> GGATCTTAGACAGGCTATG
GGGCAGTCCTGCAAAGATT -> GGCAGTCCTGCAAAGATTG
GGGCATAATCGATGGGGCC -> GGCATAATCGATGGGGCCA
GGGCCAAGTTGGACTTACA -> GGCCAAGTTGGACTTACAG
GGGCCCCAAGCGTTGGAAA -> GGCCCCAAGCGTTGGAAAA
GGGCCTCTCGTTAGTTACT -> GGCCTCTCGTTAGTTACTC
GGGCGCGGTCATTGACCAG -> GGCGCGGTCATTGACCAGA
GGGCGGTAATAACGTTGCC -> GGCGGTAATAACGTTGCCG
GGGCGTCAAAGTGCTGGCG -> GGCGTCAAAGTGCTGGCGC
GGGCTCTAACATCAAAGGA -> GGCTCTAACATCAAAGGAG
GGGGAAAAAAAGTGCCTCT -> GGGAAAAAAAGTGCCTCTG
GGGGAGACAGCGCGCCTGT -> GGGAGACAGCGCGCCTGTG
GGGGATATTGACTGTATTC -> GGGATATTGACTGTATTCG
GGGGATCTTAGACAGGCTA -> GGGATCTTAGACAGGCTAT
GGGGCATAATCGATGGGGC -> GGGCATAATCGATGGGGCC
GGGGCCAAGTTGGACTTAC -> GGGCCAAGTTGGACTTACA
GGGGCCTCTCGTTAGTTAC -> GGGCCTCTCGTTAGTTACT
GGGGGAAAAAAAGTGCCTC -> GGGGAAAAAAAGTGCCTCT
GGGGGTGCCCTCTAATACC -> GGGGTGCCCTCTAATACCC
GGGGTGCCCTCTAATACCC -> GGGTGCCCTCTAATACCCA
GGGTCCAAATTCCCGATCA -> GGTCCAAATTCCCGATCAC
GGGTGACGACAGTACAGGT -> GGTGACGACAGTACAGGTC
GGGTGCAAACCAGATGGAG -> GGTGCAAACCAGATGGAGC
GGGTGCCCTCTAATACCCA -> GGTGCCCTCTAATACCCAG
GGTAATAACGTTGCCGACT -> GTAATAACGTTGCCGACTG
GGTACACTATGTGCGACTT -> GTACACTATGTGCGACTTA
GGTACTTGTCAGTGCCTGA -> GTACTTGTCAGTGCCTGAC
GGTATACGATTTTTCTCGT -> GTATACGATTTTTCTCGTC
GGTATTCATATTACATGCA -> GTATTCATATTACATGCAT
GGTCAGTCTAATCGCAAAT -> GTCAGTCTAATCGCAAATT
GGTCATTGACCAGATGCGC -> GTCATTGACCAGATGCGCA
GGTCCAAATTCCCGATCAC -> GTCCAAATTCCCGATCACA
GGTCTCTTGGCTGCGGATG -> GTCTCTTGGCTGCGGATGG
GGTCTTTTACGCCCCAACC -> GTCTTTTACGCCCCAACCA
GGTGACGACAGTACAGGTC -> GTGACGACAGTACAGGTCT
GGTGAGAATTACATCGTAA -> GTGAGAATTACATCGTAAT
GGTGCAAACCAGATGGAGC -> GTGCAAACCAGATGGAGCC
GGTGCCCTCTAATACCCAG -> GTGCCCTCTAATACCCAGA
GGTGCTTATCTTCCTTCAA -> GTGCTTATCTTCCTTCAAG
GGTGGTATACGATTTTTCT -> GTGGTATACGATTTTTCTC
GGTGTGTTTGGAAGTTATC -> GTGTGTTTGGAAGTTATCC
GGTGTGTTTGGAGGTTGAA -> GTGTGTTTGGAGGTTGAAC
GGTGTGTTTGTCGTAACGA -> GTGTGTTTGTCGTAACGAC
GGTGTGTTTGTGAGGCTAG -> GTGTGTTTGTGAGGCTAGC
GGTTAAATCGTAACGTCTA -> GTTAAATCGTAACGTCTAT
GGTTACGTTGTCGCTCCGA -> GTTACGTTGTCGCTCCGAG
GGTTCCGCACATCATCTCG -> GTTCCGCACATCATCTCGG
GGTTCGGATTATACGGTAC -> GTTCGGATTATACGGTACA
GGTTGAACGTGTTTATGTG -> GTTGAACGTGTTTATGTGT
GGTTTCCTGGTGGTATACG -> GTTTCCTGGTGGTATACGA
GGTTTTTCATAAGCCCGCC -> GTTTTTCATAAGCCCGCCC
GTAAAACAAATTCGACACC -> TAAAACAAATTCGACACCG
GTAAAATTAACGCGTTGAG -> TAAAATTAACGCGTTGAGG
GTAACAGATACATGTTTTG -> TAACAGATACATGTTTTGG
GTAACGACCCTTGCTAGAC -> TAACGACCCTTGCTAGACG
GTAACGTCTATACCTGCTG -> TAACGTCTATACCTGCTGA
GTAATAACGTTGCCGACTG -> TAATAACGTTGCCGACTGG
GTAATGAAGCCTGATGCAC -> TAATGAAGCCTGATGCACC
GTAATTTTGAGTAGGGAAC -> TAATTTTGAGTAGGGAACT
GTACACTATGTGCGACTTA -> TACACTATGTGCGACTTAT
GTACAGGTCTTTTACGCCC -> TACAGGTCTTTTACGCCCC
GTACTGGGCCCCAAGCGTT -> TACTGGGCCCCAAGCGTTG
GTACTTGTCAGTGCCTGAC -> TACTTGTCAGTGCCTGACT
GTAGAAACAAGCCCCGAAC -> TAGAAACAAGCCCCGAACG
GTAGACCATTTTCCTGGAC -> TAGACCATTTTCCTGGACA
GTAGCCCTAACGAGCGGAA -> TAGCCCTAACGAGCGGAAT
GTAGCGTGCGATCAACGCA -> TAGCGTGCGATCAACGCAC
GTAGGGAACTAATCGTAGA -> TAGGGAACTAATCGTAGAA
GTAGTCTCGGGGATCTTAG -> TAGTCTCGGGGATCTTAGA
GTATACGATTTTTCTCGTC -> TATACGATTTTTCTCGTCT
GTATCACGGGGCATAATCG -> TATCACGGGGCATAATCGA
GTATGCATACAGATGGGCG -> TATGCATACAGATGGGCGG
GTATTCATATTACATGCAT -> TATTCATATTACATGCATA
GTATTCGAGCCACCCTCCT -> TATTCGAGCCACCCTCCTT
GTATTTAATATTATGTGAT -> TATTTAATATTATGTGATC
GTCAAACTGGTTTCCTGGT -> TCAAACTGGTTTCCTGGTG
GTCAAAGTGCTGGCGCACG -> TCAAAGTGCTGGCGCACGT
GTCAAGAATTGTGCGCGAG -> TCAAGAATTGTGCGCGAGA
GTCAATGTGAGGCGCCGAC -> TCAATGTGAGGCGCCGACA
GTCACGTCACTCACGTAGT -> TCACGTCACTCACGTAGTC
GTCACTCACGTAGTCTCGG -> TCACTCACGTAGTCTCGGG
GTCAGAAATTCGGTTTTTC -> TCAGAAATTCGGTTTTTCA
GTCAGGCGAAAACCCCATT -> TCAGGCGAAAACCCCATTG
GTCAGTCTAATCGCAAATT -> TCAGTCTAATCGCAAATTC
GTCAGTGCCTGACTCACGG -> TCAGTGCCTGACTCACGGT
GTCATCGGCTGATAGTGCT -> TCATCGGCTGATAGTGCTA
GTCATTGACCAGATGCGCA -> TCATTGACCAGATGCGCAC
GTCCAAATTCCCGATCACA -> TCCAAATTCCCGATCACAC
GTCCCGACATTAGGTGTGT -> TCCCGACATTAGGTGTGTT
GTCCGACATTAGGTGTGTT -> TCCGACATTAGGTGTGTTT
GTCCGATTTGCAGTCCGAC -> TCCGATTTGCAGTCCGACA
GTCCGGAGTCTCAGCGGAA -> TCCGGAGTCTCAGCGGAAC
GTCCGTCCGTCCTAGTGGT -> TCCGTCCGTCCTAGTGGTA
GTCCGTCCTAGTGGTATTC -> TCCGTCCTAGTGGTATTCA
GTCCTAGTGGTATTCATAT -> TCCTAGTGGTATTCATATT
GTCCTCCGCTGCCCGTCAC -> TCCTCCGCTGCCCGTCACG
GTCGAATTCCATCACCGAC -> TCGAATTCCATCACCGACA
GTCGCTCCGAGTCAGGCGA -> TCGCTCCGAGTCAGGCGAA
GTCGGTGCTTATCTTCCTT -> TCGGTGCTTATCTTCCTTC
GTCGTAACGACCCTTGCTA -> TCGTAACGACCCTTGCTAG
GTCGTTGCCTCCGCGGAAT -> TCGTTGCCTCCGCGGAATT
GTCTAATCGCAAATTCTGG -> TCTAATCGCAAATTCTGGA
GTCTAATGGCTTTCGCATG -> TCTAATGGCTTTCGCATGC
GTCTACAAGCCACAGGGCA -> TCTACAAGCCACAGGGCAG
GTCTACACCCAACACATTG -> TCTACACCCAACACATTGA
GTCTATACCTGCTGAAGTC -> TCTATACCTGCTGAAGTCT
GTCTCAGCGGAACCTGGGG -> TCTCAGCGGAACCTGGGGA
GTCTCCCTATGACGATCCC -> TCTCCCTATGACGATCCCC
GTCTCGGGGATCTTAGACA -> TCTCGGGGATCTTAGACAG
GTCTCTTGGCTGCGGATGG -> TCTCTTGGCTGCGGATGGA
GTCTGCTGGACATGCACAC -> TCTGCTGGACATGCACACT
GTCTGTGCCACATGATGGC -> TCTGTGCCACATGATGGCT
GTCTTGCGTGAGTCCCGAC -> TCTTGCGTGAGTCCCGACA
GTCTTTTACGCCCCAACCA -> TCTTTTACGCCCCAACCAC
GTGAATACACGAGGATCGC -> TGAATACACGAGGATCGCT
GTGACGACAGTACAGGTCT -> TGACGACAGTACAGGTCTT
GTGACGGACACCTTGTAGC -> TGACGGACACCTTGTAGCG
GTGAGAAGTGGCTGGACAA -> TGAGAAGTGGCTGGACAAA
GTGAGAATTACATCGTAAT -> TGAGAATTACATCGTAATT
GTGAGCATGTGACGGACAC -> TGAGCATGTGACGGACACC
GTGAGGCGCCGACATTAGG -> TGAGGCGCCGACATTAGGT
GTGAGGCTAGCCGTTAAGC -> TGAGGCTAGCCGTTAAGCA
GTGAGTCCCGACATTAGGT -> TGAGTCCCGACATTAGGTG
GTGATCGTAAAATTAACGC -> TGATCGTAAAATTAACGCG
GTGCAAACCAGATGGAGCC -> TGCAAACCAGATGGAGCCT
GTGCACACGTCTGTGCCAC -> TGCACACGTCTGTGCCACA
GTGCATGTTCTTGGCAAGC -> TGCATGTTCTTGGCAAGCC
GTGCCACATGATGGCTTAC -> TGCCACATGATGGCTTACC
GTGCCCTCTAATACCCAGA -> TGCCCTCTAATACCCAGAT
GTGCCTCTGCAATTAGAAC -> TGCCTCTGCAATTAGAACA
GTGCCTGACTCACGGTCAG -> TGCCTGACTCACGGTCAGT
GTGCGACTTATTCGACATG -> TGCGACTTATTCGACATGA
GTGCGATCAACGCACACGG -> TGCGATCAACGCACACGGC
GTGCGCCTACCATGATCCT -> TGCGCCTACCATGATCCTG
GTGCGCGAGACATACATTA -> TGCGCGAGACATACATTAA
GTGCTATTTATGATGATCA -> TGCTATTTATGATGATCAG
GTGCTGGCGCACGTCGGTG -> TGCTGGCGCACGTCGGTGC
GTGCTTATCTTCCTTCAAG -> TGCTTATCTTCCTTCAAGC
GTGGCACTGAGATAACTGA -> TGGCACTGAGATAACTGAT
GTGGCTGGAATGCTAGTCA -> TGGCTGGAATGCTAGTCAA
GTGGCTGGACAAAAGGGAC -> TGGCTGGACAAAAGGGACG
GTGGGTGACGACAGTACAG -> TGGGTGACGACAGTACAGG
GTGGTATACGATTTTTCTC -> TGGTATACGATTTTTCTCG
GTGGTATTCATATTACATG -> TGGTATTCATATTACATGC
GTGGTTACGTTGTCGCTCC -> TGGTTACGTTGTCGCTCCG
GTGTGAGAAGTGGCTGGAC -> TGTGAGAAGTGGCTGGACA
GTGTGTTTGGAAGTTATCC -> TGTGTTTGGAAGTTATCCA
GTGTGTTTGGAGGTTGAAC -> TGTGTTTGGAGGTTGAACG
GTGTGTTTGTCGTAACGAC -> TGTGTTTGTCGTAACGACC
GTGTGTTTGTGAGGCTAGC -> TGTGTTTGTGAGGCTAGCC
GTGTTCACTCCGGTGAGAA -> TGTTCACTCCGGTGAGAAT
GTGTTTATGTGTGAGAAGT -> TGTTTATGTGTGAGAAGTG
GTGTTTGGAAGTTATCCAT -> TGTTTGGAAGTTATCCATG
GTGTTTGGAGGTTGAACGT -> TGTTTGGAGGTTGAACGTG
GTGTTTGTCGTAACGACCC -> TGTTTGTCGTAACGACCCT
GTGTTTGTGAGGCTAGCCG -> TGTTTGTGAGGCTAGCCGT
GTTAAATCGTAACGTCTAT -> TTAAATCGTAACGTCTATA
GTTAAGCATCACGATCTCG -> TTAAGCATCACGATCTCGT
GTTACGTTGTCGCTCCGAG -> TTACGTTGTCGCTCCGAGT
GTTACTCATCTTACCACCC -> TTACTCATCTTACCACCCC
GTTAGTTACTCATCTTACC -> TTAGTTACTCATCTTACCA
GTTATCCATGCGTGTTCAC -> TTATCCATGCGTGTTCACT
GTTATGACTTACTACAACG -> TTATGACTTACTACAACGT
GTTCACTCCGGTGAGAATT -> TTCACTCCGGTGAGAATTA
GTTCATACTTCTCCACAGC -> TTCATACTTCTCCACAGCA
GTTCCGCACATCATCTCGG -> TTCCGCACATCATCTCGGC
GTTCGACCTCAGGCCTACC -> TTCGACCTCAGGCCTACCT
GTTCGGATTATACGGTACA -> TTCGGATTATACGGTACAC
GTTCTAACGAATTCTCAAG -> TTCTAACGAATTCTCAAGG
GTTCTTGGCAAGCCACAAC -> TTCTTGGCAAGCCACAACT
GTTGAACGTGTTTATGTGT -> TTGAACGTGTTTATGTGTG
GTTGAGGTCTCTTGGCTGC -> TTGAGGTCTCTTGGCTGCG
GTTGCCCATCCGGCGCGCG -> TTGCCCATCCGGCGCGCGA
GTTGCCGACTGGACATGCA -> TTGCCGACTGGACATGCAC
GTTGCCTCCGCGGAATTAA -> TTGCCTCCGCGGAATTAAG
GTTGGAAAAAAGTCTACAA -> TTGGAAAAAAGTCTACAAG
GTTGGACTTACAGGGTCCA -> TTGGACTTACAGGGTCCAA
GTTGGGAACAGAAATGCGC -> TTGGGAACAGAAATGCGCC
GTTGTCGCTCCGAGTCAGG -> TTGTCGCTCCGAGTCAGGC
GTTTATGTGTGAGAAGTGG -> TTTATGTGTGAGAAGTGGC
GTTTCCTGGTGGTATACGA -> TTTCCTGGTGGTATACGAT
GTTTCGTTCTAACGAATTC -> TTTCGTTCTAACGAATTCT
GTTTGGAAGTTATCCATGC -> TTTGGAAGTTATCCATGCG
GTTTGGAGGTTGAACGTGT -> TTTGGAGGTTGAACGTGTT
GTTTGTCGTAACGACCCTT -> TTTGTCGTAACGACCCTTG
GTTTGTGAGGCTAGCCGTT -> TTTGTGAGGCTAGCCGTTA
GTTTTGGTTCCGCACATCA -> TTTTGGTTCCGCACATCAT
GTTTTTCATAAGCCCGCCC -> TTTTTCATAAGCCCGCCCA
TAAAAACCCACGTGCATGT -> AAAAACCCACGTGCATGTT
TAAAACAAATTCGACACCG -> AAAACAAATTCGACACCGC
TAAAATTAACGCGTTGAGG -> AAAATTAACGCGTTGAGGT
TAAACTTCGAAGAAAACCT -> AAACTTCGAAGAAAACCTA
TAAATCGTAACGTCTATAC -> AAATCGTAACGTCTATACC
TAACAGATACATGTTTTGG -> AACAGATACATGTTTTGGT
TAACATCAAAGGAGATTCA -> AACATCAAAGGAGATTCAT
TAACCCTACCACCAATTCT -> AACCCTACCACCAATTCTG
TAACGAATTCTCAAGGGGG -> AACGAATTCTCAAGGGGGT
TAACGACCCTTGCTAGACG -> AACGACCCTTGCTAGACGA
TAACGAGCGGAATAAAAAC -> AACGAGCGGAATAAAAACC
TAACGCGTTGAGGTCTCTT -> AACGCGTTGAGGTCTCTTG
TAACGTCTATACCTGCTGA -> AACGTCTATACCTGCTGAA
TAACGTTGCCGACTGGACA -> AACGTTGCCGACTGGACAT
TAACTCACCATGCGCACCC -> AACTCACCATGCGCACCCT
TAACTGATGGCGCTGCACA -> AACTGATGGCGCTGCACAC
TAACTGGATGAACATGGGG -> AACTGGATGAACATGGGGC
TAAGCATCACGATCTCGTA -> AAGCATCACGATCTCGTAG
TAAGCCCGCCCATGAAAGG -> AAGCCCGCCCATGAAAGGC
TAAGCGCGCCGATTAGTGA -> AAGCGCGCCGATTAGTGAG
TAAGCTGCTCCTATGATGC -> AAGCTGCTCCTATGATGCC
TAATAACGTTGCCGACTGG -> AATAACGTTGCCGACTGGA
TAATACCCAGATGAAAGCA -> AATACCCAGATGAAAGCAT
TAATATTATGTGATCGTAA -> AATATTATGTGATCGTAAA
TAATCGATGGGGCCAAGTT -> AATCGATGGGGCCAAGTTG
TAATCGCAAATTCTGGACA -> AATCGCAAATTCTGGACAT
TAATCGTAGAAACAAGCCC -> AATCGTAGAAACAAGCCCC
TAATGAAGCCTGATGCACC -> AATGAAGCCTGATGCACCG
TAATGGCTTTCGCATGCGT -> AATGGCTTTCGCATGCGTA
TAATTTTGAGTAGGGAACT -> AATTTTGAGTAGGGAACTA
TACAACGTCATCGGCTGAT -> ACAACGTCATCGGCTGATA
TACAACTAGTTTCGTTCTA -> ACAACTAGTTTCGTTCTAA
TACAAGCCACAGGGCAGTC -> ACAAGCCACAGGGCAGTCC
TACACCCAACACATTGAGT -> ACACCCAACACATTGAGTA
TACACGAGGATCGCTGCTC -> ACACGAGGATCGCTGCTCC
TACACTATGTGCGACTTAT -> ACACTATGTGCGACTTATT
TACAGATGGGCGGTAATAA -> ACAGATGGGCGGTAATAAC
TACAGGGTCCAAATTCCCG -> ACAGGGTCCAAATTCCCGA
TACAGGTCTTTTACGCCCC -> ACAGGTCTTTTACGCCCCA
TACATCGTAATTTTGAGTA -> ACATCGTAATTTTGAGTAG
TACATGCATACCATGGATT -> ACATGCATACCATGGATTG
TACATGTTTTGGTTCCGCA -> ACATGTTTTGGTTCCGCAC
TACATTAAACTTCGAAGAA -> ACATTAAACTTCGAAGAAA
TACCAACCCGGACATGGAG -> ACCAACCCGGACATGGAGG
TACCACCAATTCTGCGGGC -> ACCACCAATTCTGCGGGCT
TACCACCCCAACGCTCGAC -> ACCACCCCAACGCTCGACT
TACCATGATCCTGAGTGAA -> ACCATGATCCTGAGTGAAT
TACCATGGATTGTACTGGG -> ACCATGGATTGTACTGGGC
TACCCAGATGAAAGCATTA -> ACCCAGATGAAAGCATTAT
TACCTGCTGAAGTCTAATG -> ACCTGCTGAAGTCTAATGG
TACCTGTCAAACTGGTTTC -> ACCTGTCAAACTGGTTTCC
TACGACCGATGTATCACGG -> ACGACCGATGTATCACGGG
TACGATTTTTCTCGTCTAC -> ACGATTTTTCTCGTCTACA
TACGCCCCAACCACGCGAT -> ACGCCCCAACCACGCGATT
TACGGTACACTATGTGCGA -> ACGGTACACTATGTGCGAC
TACGTTGTCGCTCCGAGTC -> ACGTTGTCGCTCCGAGTCA
TACTACAACGTCATCGGCT -> ACTACAACGTCATCGGCTG
TACTCATCTTACCACCCCA -> ACTCATCTTACCACCCCAA
TACTGGGCCCCAAGCGTTG -> ACTGGGCCCCAAGCGTTGG
TACTTCTCCACAGCAGCCT -> ACTTCTCCACAGCAGCCTT
TACTTGTCAGTGCCTGACT -> ACTTGTCAGTGCCTGACTC
TAGAAACAAGCCCCGAACG -> AGAAACAAGCCCCGAACGT
TAGAACATGAGTCTGCTGG -> AGAACATGAGTCTGCTGGA
TAGACAGGCTATGGGGATA -> AGACAGGCTATGGGGATAT
TAGACCATTTTCCTGGACA -> AGACCATTTTCCTGGACAT
TAGACGAACGTAGACCATT -> AGACGAACGTAGACCATTT
TAGATGGAGTTCATACTTC -> AGATGGAGTTCATACTTCT
TAGCAATGATCCAGGCCCC -> AGCAATGATCCAGGCCCCT
TAGCCCTAACGAGCGGAAT -> AGCCCTAACGAGCGGAATA
TAGCCGTTAAGCATCACGA -> AGCCGTTAAGCATCACGAT
TAGCGTGCGATCAACGCAC -> AGCGTGCGATCAACGCACA
TAGGGAACTAATCGTAGAA -> AGGGAACTAATCGTAGAAA
TAGGTGTGTTTGGAAGTTA -> AGGTGTGTTTGGAAGTTAT
TAGGTGTGTTTGGAGGTTG -> AGGTGTGTTTGGAGGTTGA
TAGGTGTGTTTGTCGTAAC -> AGGTGTGTTTGTCGTAACG
TAGGTGTGTTTGTGAGGCT -> AGGTGTGTTTGTGAGGCTA
TAGTAAAACAAATTCGACA -> AGTAAAACAAATTCGACAC
TAGTCAAGAATTGTGCGCG -> AGTCAAGAATTGTGCGCGA
TAGTCTCGGGGATCTTAGA -> AGTCTCGGGGATCTTAGAC
TAGTGAGCATGTGACGGAC -> AGTGAGCATGTGACGGACA
TAGTGCTATTTATGATGAT -> AGTGCTATTTATGATGATC
TAGTGGTATTCATATTACA -> AGTGGTATTCATATTACAT
TAGTTACTCATCTTACCAC -> AGTTACTCATCTTACCACC
TAGTTTCGTTCTAACGAAT -> AGTTTCGTTCTAACGAATT
TATACAACTAGTTTCGTTC -> ATACAACTAGTTTCGTTCT
TATACCTGCTGAAGTCTAA -> ATACCTGCTGAAGTCTAAT
TATACGATTTTTCTCGTCT -> ATACGATTTTTCTCGTCTA
TATACGGTACACTATGTGC -> ATACGGTACACTATGTGCG
TATCACGGGGCATAATCGA -> ATCACGGGGCATAATCGAT
TATCCATGCGTGTTCACTC -> ATCCATGCGTGTTCACTCC
TATCGGCTTCGCGTTATGA -> ATCGGCTTCGCGTTATGAC
TATCGGGCGTCAAAGTGCT -> ATCGGGCGTCAAAGTGCTG
TATCTTCCTTCAAGCTCGA -> ATCTTCCTTCAAGCTCGAA
TATCTTTCACAAGTCGTTG -> ATCTTTCACAAGTCGTTGC
TATGAAGCCGAAACTTATC -> ATGAAGCCGAAACTTATCT
TATGACGATCCCCGTAACA -> ATGACGATCCCCGTAACAG
TATGACTTACTACAACGTC -> ATGACTTACTACAACGTCA
TATGATGATCAGTGGCACT -> ATGATGATCAGTGGCACTG
TATGATGCCGAATCAGCAG -> ATGATGCCGAATCAGCAGT
TATGCATACAGATGGGCGG -> ATGCATACAGATGGGCGGT
TATGGGGATATTGACTGTA -> ATGGGGATATTGACTGTAT
TATGTGATCGTAAAATTAA -> ATGTGATCGTAAAATTAAC
TATGTGCGACTTATTCGAC -> ATGTGCGACTTATTCGACA
TATGTGTGAGAAGTGGCTG -> ATGTGTGAGAAGTGGCTGG
TATTACATGCATACCATGG -> ATTACATGCATACCATGGA
TATTAGATGGAGTTCATAC -> ATTAGATGGAGTTCATACT
TATTATGTGATCGTAAAAT -> ATTATGTGATCGTAAAATT
TATTCATATTACATGCATA -> ATTCATATTACATGCATAC
TATTCGACATGATGCCCCA -> ATTCGACATGATGCCCCAA
TATTCGAGCCACCCTCCTT -> ATTCGAGCCACCCTCCTTT
TATTGACTGTATTCGAGCC -> ATTGACTGTATTCGAGCCA
TATTTAATATTATGTGATC -> ATTTAATATTATGTGATCG
TATTTATGATGATCAGTGG -> ATTTATGATGATCAGTGGC
TCAAACTGGTTTCCTGGTG -> CAAACTGGTTTCCTGGTGG
TCAAAGGAGATTCATGTGC -> CAAAGGAGATTCATGTGCA
TCAAAGTGCTGGCGCACGT -> CAAAGTGCTGGCGCACGTC
TCAACGCACACGGCGGGGG -> CAACGCACACGGCGGGGGA
TCAAGAATTGTGCGCGAGA -> CAAGAATTGTGCGCGAGAC
TCAAGCTCGAACTAGCAAT -> CAAGCTCGAACTAGCAATG
TCAAGGGGGTGCCCTCTAA -> CAAGGGGGTGCCCTCTAAT
TCAATGTGAGGCGCCGACA -> CAATGTGAGGCGCCGACAT
TCACAAGTCGTTGCCTCCG -> CACAAGTCGTTGCCTCCGC
TCACACGCACGAGTATGCA -> CACACGCACGAGTATGCAT
TCACCATGCGCACCCTTAT -> CACCATGCGCACCCTTATC
TCACCGACATTAGGTGTGT -> CACCGACATTAGGTGTGTT
TCACGATCTCGTAGCCCTA -> CACGATCTCGTAGCCCTAA
TCACGGGGCATAATCGATG -> CACGGGGCATAATCGATGG
TCACGGTCAGTCTAATCGC -> CACGGTCAGTCTAATCGCA
TCACGTAGTCTCGGGGATC -> CACGTAGTCTCGGGGATCT
TCACGTCACTCACGTAGTC -> CACGTCACTCACGTAGTCT
TCACTCACGTAGTCTCGGG -> CACTCACGTAGTCTCGGGG
TCACTCCGGTGAGAATTAC -> CACTCCGGTGAGAATTACA
TCAGAAATTCGGTTTTTCA -> CAGAAATTCGGTTTTTCAT
TCAGCAGTGGTTACGTTGT -> CAGCAGTGGTTACGTTGTC
TCAGCGGAACCTGGGGAGA -> CAGCGGAACCTGGGGAGAC
TCAGGCCTACCTGTCAAAC -> CAGGCCTACCTGTCAAACT
TCAGGCGAAAACCCCATTG -> CAGGCGAAAACCCCATTGT
TCAGTCTAATCGCAAATTC -> CAGTCTAATCGCAAATTCT
TCAGTGCCTGACTCACGGT -> CAGTGCCTGACTCACGGTC
TCAGTGGCACTGAGATAAC -> CAGTGGCACTGAGATAACT
TCATAAGCCCGCCCATGAA -> CATAAGCCCGCCCATGAAA
TCATACTTCTCCACAGCAG -> CATACTTCTCCACAGCAGC
TCATATTACATGCATACCA -> CATATTACATGCATACCAT
TCATCGGCTGATAGTGCTA -> CATCGGCTGATAGTGCTAT
TCATCTCGGCCCTGCTGCA -> CATCTCGGCCCTGCTGCAG
TCATCTTACCACCCCAACG -> CATCTTACCACCCCAACGC
TCATGTGCACACGTCTGTG -> CATGTGCACACGTCTGTGC
TCATTGACCAGATGCGCAC -> CATTGACCAGATGCGCACG
TCCAAATTCCCGATCACAC -> CCAAATTCCCGATCACACG
TCCACAGCAGCCTTAAGCG -> CCACAGCAGCCTTAAGCGC
TCCAGGCCCCTGCACTTAT -> CCAGGCCCCTGCACTTATG
TCCATCACCGACATTAGGT -> CCATCACCGACATTAGGTG
TCCATGCGTGTTCACTCCG -> CCATGCGTGTTCACTCCGG
TCCCCGTAACAGATACATG -> CCCCGTAACAGATACATGT
TCCCGACATTAGGTGTGTT -> CCCGACATTAGGTGTGTTT
TCCCGATCACACGCACGAG -> CCCGATCACACGCACGAGT
TCCCTATGACGATCCCCGT -> CCCTATGACGATCCCCGTA
TCCGACATTAGGTGTGTTT -> CCGACATTAGGTGTGTTTG
TCCGAGTCAGGCGAAAACC -> CCGAGTCAGGCGAAAACCC
TCCGATTTGCAGTCCGACA -> CCGATTTGCAGTCCGACAT
TCCGCACATCATCTCGGCC -> CCGCACATCATCTCGGCCC
TCCGCGGAATTAAGCTGCT -> CCGCGGAATTAAGCTGCTC
TCCGCTGCCCGTCACGTCA -> CCGCTGCCCGTCACGTCAC
TCCGGAGTCTCAGCGGAAC -> CCGGAGTCTCAGCGGAACC
TCCGGCGCGCGAGCCGTCA -> CCGGCGCGCGAGCCGTCAG
TCCGGGCGCGGTCATTGAC -> CCGGGCGCGGTCATTGACC
TCCGGTGAGAATTACATCG -> CCGGTGAGAATTACATCGT
TCCGTCCGTCCTAGTGGTA -> CCGTCCGTCCTAGTGGTAT
TCCGTCCTAGTGGTATTCA -> CCGTCCTAGTGGTATTCAT
TCCTAGTGGTATTCATATT -> CCTAGTGGTATTCATATTA
TCCTATGATGCCGAATCAG -> CCTATGATGCCGAATCAGC
TCCTCCGCTGCCCGTCACG -> CCTCCGCTGCCCGTCACGT
TCCTGAGTGAATACACGAG -> CCTGAGTGAATACACGAGG
TCCTGGACATGCACACTGT -> CCTGGACATGCACACTGTC
TCCTGGTGGTATACGATTT -> CCTGGTGGTATACGATTTT
TCCTTCAAGCTCGAACTAG -> CCTTCAAGCTCGAACTAGC
TCCTTTATACAACTAGTTT -> CCTTTATACAACTAGTTTC
TCGAAAGACGATGCTGTGG -> CGAAAGACGATGCTGTGGC
TCGAACTAGCAATGATCCA -> CGAACTAGCAATGATCCAG
TCGAAGAAAACCTAACTCA -> CGAAGAAAACCTAACTCAC
TCGAATTCCATCACCGACA -> CGAATTCCATCACCGACAT
TCGACACCGCGTTCGACCT -> CGACACCGCGTTCGACCTC
TCGACATGATGCCCCAAGT -> CGACATGATGCCCCAAGTT
TCGACCTCAGGCCTACCTG -> CGACCTCAGGCCTACCTGT
TCGACTAACCCTACCACCA -> CGACTAACCCTACCACCAA
TCGAGCCACCCTCCTTTAT -> CGAGCCACCCTCCTTTATA
TCGATGGGGCCAAGTTGGA -> CGATGGGGCCAAGTTGGAC
TCGCAAATTCTGGACATGC -> CGCAAATTCTGGACATGCA
TCGCATGCGTATTTAATAT -> CGCATGCGTATTTAATATT
TCGCGTTATGACTTACTAC -> CGCGTTATGACTTACTACA
TCGCTCCGAGTCAGGCGAA -> CGCTCCGAGTCAGGCGAAA
TCGCTGCTCCGGGCGCGGT -> CGCTGCTCCGGGCGCGGTC
TCGGAATGATTTACGACCG -> CGGAATGATTTACGACCGA
TCGGATTATACGGTACACT -> CGGATTATACGGTACACTA
TCGGCCCTGCTGCAGCTGT -> CGGCCCTGCTGCAGCTGTC
TCGGCTGATAGTGCTATTT -> CGGCTGATAGTGCTATTTA
TCGGCTTCGCGTTATGACT -> CGGCTTCGCGTTATGACTT
TCGGGCGTCAAAGTGCTGG -> CGGGCGTCAAAGTGCTGGC
TCGGGGATCTTAGACAGGC -> CGGGGATCTTAGACAGGCT
TCGGTGCTTATCTTCCTTC -> CGGTGCTTATCTTCCTTCA
TCGGTTTTTCATAAGCCCG -> CGGTTTTTCATAAGCCCGC
TCGTAAAATTAACGCGTTG -> CGTAAAATTAACGCGTTGA
TCGTAACGACCCTTGCTAG -> CGTAACGACCCTTGCTAGA
TCGTAACGTCTATACCTGC -> CGTAACGTCTATACCTGCT
TCGTAATTTTGAGTAGGGA -> CGTAATTTTGAGTAGGGAA
TCGTAGAAACAAGCCCCGA -> CGTAGAAACAAGCCCCGAA
TCGTAGCCCTAACGAGCGG -> CGTAGCCCTAACGAGCGGA
TCGTCCTCCGCTGCCCGTC -> CGTCCTCCGCTGCCCGTCA
TCGTCTACACCCAACACAT -> CGTCTACACCCAACACATT
TCGTTAGTTACTCATCTTA -> CGTTAGTTACTCATCTTAC
TCGTTCTAACGAATTCTCA -> CGTTCTAACGAATTCTCAA
TCGTTGCCTCCGCGGAATT -> CGTTGCCTCCGCGGAATTA
TCTAACATCAAAGGAGATT -> CTAACATCAAAGGAGATTC
TCTAACGAATTCTCAAGGG -> CTAACGAATTCTCAAGGGG
TCTAATACCCAGATGAAAG -> CTAATACCCAGATGAAAGC
TCTAATCGCAAATTCTGGA -> CTAATCGCAAATTCTGGAC
TCTAATGGCTTTCGCATGC -> CTAATGGCTTTCGCATGCG
TCTACAAGCCACAGGGCAG -> CTACAAGCCACAGGGCAGT
TCTACACCCAACACATTGA -> CTACACCCAACACATTGAG
TCTATACCTGCTGAAGTCT -> CTATACCTGCTGAAGTCTA
TCTCAAGGGGGTGCCCTCT -> CTCAAGGGGGTGCCCTCTA
TCTCAGCGGAACCTGGGGA -> CTCAGCGGAACCTGGGGAG
TCTCCACAGCAGCCTTAAG -> CTCCACAGCAGCCTTAAGC
TCTCCCTATGACGATCCCC -> CTCCCTATGACGATCCCCG
TCTCGGCCCTGCTGCAGCT -> CTCGGCCCTGCTGCAGCTG
TCTCGGGGATCTTAGACAG -> CTCGGGGATCTTAGACAGG
TCTCGTAGCCCTAACGAGC -> CTCGTAGCCCTAACGAGCG
TCTCGTCTACACCCAACAC -> CTCGTCTACACCCAACACA
TCTCGTTAGTTACTCATCT -> CTCGTTAGTTACTCATCTT
TCTCTTGGCTGCGGATGGA -> CTCTTGGCTGCGGATGGAT
TCTGCAATTAGAACATGAG -> CTGCAATTAGAACATGAGT
TCTGCGGGCTCTAACATCA -> CTGCGGGCTCTAACATCAA
TCTGCTGGACATGCACACT -> CTGCTGGACATGCACACTG
TCTGGACATGCACACTGTC -> CTGGACATGCACACTGTCT
TCTGTGCCACATGATGGCT -> CTGTGCCACATGATGGCTT
TCTTACCACCCCAACGCTC -> CTTACCACCCCAACGCTCG
TCTTAGACAGGCTATGGGG -> CTTAGACAGGCTATGGGGA
TCTTCCTTCAAGCTCGAAC -> CTTCCTTCAAGCTCGAACT
TCTTGCGTGAGTCCCGACA -> CTTGCGTGAGTCCCGACAT
TCTTGGCAAGCCACAACTG -> CTTGGCAAGCCACAACTGG
TCTTGGCTGCGGATGGATT -> CTTGGCTGCGGATGGATTC
TCTTTCACAAGTCGTTGCC -> CTTTCACAAGTCGTTGCCT
TCTTTTACGCCCCAACCAC -> CTTTTACGCCCCAACCACG
TGAAAGCATTATTAGATGG -> GAAAGCATTATTAGATGGA
TGAAAGGCTTGCCCAACCC -> GAAAGGCTTGCCCAACCCT
TGAACATGGGGCCTCTCGT -> GAACATGGGGCCTCTCGTT
TGAACGTGTTTATGTGTGA -> GAACGTGTTTATGTGTGAG
TGAAGCCGAAACTTATCTT -> GAAGCCGAAACTTATCTTT
TGAAGCCTGATGCACCGCT -> GAAGCCTGATGCACCGCTC
TGAAGTCTAATGGCTTTCG -> GAAGTCTAATGGCTTTCGC
TGAATACACGAGGATCGCT -> GAATACACGAGGATCGCTG
TGACACTTATCGGCTTCGC -> GACACTTATCGGCTTCGCG
TGACCAGATGCGCACGATG -> GACCAGATGCGCACGATGA
TGACGACAGTACAGGTCTT -> GACGACAGTACAGGTCTTT
TGACGATCCCCGTAACAGA -> GACGATCCCCGTAACAGAT
TGACGGACACCTTGTAGCG -> GACGGACACCTTGTAGCGT
TGACTCACGGTCAGTCTAA -> GACTCACGGTCAGTCTAAT
TGACTGTATTCGAGCCACC -> GACTGTATTCGAGCCACCC
TGACTTACTACAACGTCAT -> GACTTACTACAACGTCATC
TGAGAAGTGGCTGGACAAA -> GAGAAGTGGCTGGACAAAA
TGAGAATTACATCGTAATT -> GAGAATTACATCGTAATTT
TGAGATAACTGATGGCGCT -> GAGATAACTGATGGCGCTG
TGAGCATGTGACGGACACC -> GAGCATGTGACGGACACCT
TGAGGCGCCGACATTAGGT -> GAGGCGCCGACATTAGGTG
TGAGGCTAGCCGTTAAGCA -> GAGGCTAGCCGTTAAGCAT
TGAGGTCTCTTGGCTGCGG -> GAGGTCTCTTGGCTGCGGA
TGAGTAATGAAGCCTGATG -> GAGTAATGAAGCCTGATGC
TGAGTAGGGAACTAATCGT -> GAGTAGGGAACTAATCGTA
TGAGTCCCGACATTAGGTG -> GAGTCCCGACATTAGGTGT
TGAGTCTGCTGGACATGCA -> GAGTCTGCTGGACATGCAC
TGAGTGAATACACGAGGAT -> GAGTGAATACACGAGGATC
TGATAGTGCTATTTATGAT -> GATAGTGCTATTTATGATG
TGATCAGTGGCACTGAGAT -> GATCAGTGGCACTGAGATA
TGATCCAGGCCCCTGCACT -> GATCCAGGCCCCTGCACTT
TGATCCTGAGTGAATACAC -> GATCCTGAGTGAATACACG
TGATCGTAAAATTAACGCG -> GATCGTAAAATTAACGCGT
TGATGATCAGTGGCACTGA -> GATGATCAGTGGCACTGAG
TGATGCACCGCTCGAAAGA -> GATGCACCGCTCGAAAGAC
TGATGCCCCAAGTTGGGAA -> GATGCCCCAAGTTGGGAAC
TGATGCCGAATCAGCAGTG -> GATGCCGAATCAGCAGTGG
TGATGGCGCTGCACACGTC -> GATGGCGCTGCACACGTCT
TGATGGCTTACCAACCCGG -> GATGGCTTACCAACCCGGA
TGATTTACGACCGATGTAT -> GATTTACGACCGATGTATC
TGCAAACCAGATGGAGCCT -> GCAAACCAGATGGAGCCTA
TGCAATTAGAACATGAGTC -> GCAATTAGAACATGAGTCT
TGCACACGTCTCCCTATGA -> GCACACGTCTCCCTATGAC
TGCACACGTCTGTGCCACA -> GCACACGTCTGTGCCACAT
TGCACACTGTCAATGTGAG -> GCACACTGTCAATGTGAGG
TGCACACTGTCCGATTTGC -> GCACACTGTCCGATTTGCA
TGCACACTGTCGAATTCCA -> GCACACTGTCGAATTCCAT
TGCACACTGTCTTGCGTGA -> GCACACTGTCTTGCGTGAG
TGCACCGCTCGAAAGACGA -> GCACCGCTCGAAAGACGAT
TGCACTTATGAAGCCGAAA -> GCACTTATGAAGCCGAAAC
TGCAGCTGTCCGGAGTCTC -> GCAGCTGTCCGGAGTCTCA
TGCAGTCCGACATTAGGTG -> GCAGTCCGACATTAGGTGT
TGCATACAGATGGGCGGTA -> GCATACAGATGGGCGGTAA
TGCATACCATGGATTGTAC -> GCATACCATGGATTGTACT
TGCATGTTCTTGGCAAGCC -> GCATGTTCTTGGCAAGCCA
TGCCACATGATGGCTTACC -> GCCACATGATGGCTTACCA
TGCCCAACCCTAACTGGAT -> GCCCAACCCTAACTGGATG
TGCCCATCCGGCGCGCGAG -> GCCCATCCGGCGCGCGAGC
TGCCCCAAGTTGGGAACAG -> GCCCCAAGTTGGGAACAGA
TGCCCGTCACGTCACTCAC -> GCCCGTCACGTCACTCACG
TGCCCTCTAATACCCAGAT -> GCCCTCTAATACCCAGATG
TGCCGAATCAGCAGTGGTT -> GCCGAATCAGCAGTGGTTA
TGCCGACTGGACATGCACA -> GCCGACTGGACATGCACAC
TGCCTCCGCGGAATTAAGC -> GCCTCCGCGGAATTAAGCT
TGCCTCTGCAATTAGAACA -> GCCTCTGCAATTAGAACAT
TGCCTGACTCACGGTCAGT -> GCCTGACTCACGGTCAGTC
TGCGACTTATTCGACATGA -> GCGACTTATTCGACATGAT
TGCGATCAACGCACACGGC -> GCGATCAACGCACACGGCG
TGCGCACCCTTATCGGGCG -> GCGCACCCTTATCGGGCGT
TGCGCACGATGACACTTAT -> GCGCACGATGACACTTATC
TGCGCCTACCATGATCCTG -> GCGCCTACCATGATCCTGA
TGCGCCTCGGAATGATTTA -> GCGCCTCGGAATGATTTAC
TGCGCGAGACATACATTAA -> GCGCGAGACATACATTAAA
TGCGGATGGATTCGTCCTC -> GCGGATGGATTCGTCCTCC
TGCGGGCTCTAACATCAAA -> GCGGGCTCTAACATCAAAG
TGCGTATTTAATATTATGT -> GCGTATTTAATATTATGTG
TGCGTGAGTCCCGACATTA -> GCGTGAGTCCCGACATTAG
TGCGTGTTCACTCCGGTGA -> GCGTGTTCACTCCGGTGAG
TGCTAGACGAACGTAGACC -> GCTAGACGAACGTAGACCA
TGCTAGTCAAGAATTGTGC -> GCTAGTCAAGAATTGTGCG
TGCTATTTATGATGATCAG -> GCTATTTATGATGATCAGT
TGCTCCGGGCGCGGTCATT -> GCTCCGGGCGCGGTCATTG
TGCTCCTATGATGCCGAAT -> GCTCCTATGATGCCGAATC
TGCTGAAGTCTAATGGCTT -> GCTGAAGTCTAATGGCTTT
TGCTGCAGCTGTCCGGAGT -> GCTGCAGCTGTCCGGAGTC
TGCTGGACATGCACACTGT -> GCTGGACATGCACACTGTC
TGCTGGCGCACGTCGGTGC -> GCTGGCGCACGTCGGTGCT
TGCTGTGGCTGGAATGCTA -> GCTGTGGCTGGAATGCTAG
TGCTTATCTTCCTTCAAGC -> GCTTATCTTCCTTCAAGCT
TGGAAAAAAGTCTACAAGC -> GGAAAAAAGTCTACAAGCC
TGGAAGTTATCCATGCGTG -> GGAAGTTATCCATGCGTGT
TGGAATGCTAGTCAAGAAT -> GGAATGCTAGTCAAGAATT
TGGACAAAAGGGACGGTTC -> GGACAAAAGGGACGGTTCG
TGGACATGCACACTGTCAA -> GGACATGCACACTGTCAAT
TGGACATGCACACTGTCCG -> GGACATGCACACTGTCCGA
TGGACATGCACACTGTCGA -> GGACATGCACACTGTCGAA
TGGACATGCACACTGTCTT -> GGACATGCACACTGTCTTG
TGGACTTACAGGGTCCAAA -> GGACTTACAGGGTCCAAAT
TGGAGCCTAGTAAAACAAA -> GGAGCCTAGTAAAACAAAT
TGGAGGCAGGGTGCAAACC -> GGAGGCAGGGTGCAAACCA
TGGAGGTTGAACGTGTTTA -> GGAGGTTGAACGTGTTTAT
TGGAGTTCATACTTCTCCA -> GGAGTTCATACTTCTCCAC
TGGATGAACATGGGGCCTC -> GGATGAACATGGGGCCTCT
TGGATTCGTCCTCCGCTGC -> GGATTCGTCCTCCGCTGCC
TGGATTGTACTGGGCCCCA -> GGATTGTACTGGGCCCCAA
TGGCAAGCCACAACTGGCG -> GGCAAGCCACAACTGGCGG
TGGCACTGAGATAACTGAT -> GGCACTGAGATAACTGATG
TGGCGCACGTCGGTGCTTA -> GGCGCACGTCGGTGCTTAT
TGGCGCTGCACACGTCTCC -> GGCGCTGCACACGTCTCCC
TGGCGGTACTTGTCAGTGC -> GGCGGTACTTGTCAGTGCC
TGGCTGCGGATGGATTCGT -> GGCTGCGGATGGATTCGTC
TGGCTGGAATGCTAGTCAA -> GGCTGGAATGCTAGTCAAG
TGGCTGGACAAAAGGGACG -> GGCTGGACAAAAGGGACGG
TGGCTTACCAACCCGGACA -> GGCTTACCAACCCGGACAT
TGGCTTTCGCATGCGTATT -> GGCTTTCGCATGCGTATTT
TGGGAACAGAAATGCGCCT -> GGGAACAGAAATGCGCCTC
TGGGCCCCAAGCGTTGGAA -> GGGCCCCAAGCGTTGGAAA
TGGGCGGTAATAACGTTGC -> GGGCGGTAATAACGTTGCC
TGGGGAGACAGCGCGCCTG -> GGGGAGACAGCGCGCCTGT
TGGGGATATTGACTGTATT -> GGGGATATTGACTGTATTC
TGGGGCCAAGTTGGACTTA -> GGGGCCAAGTTGGACTTAC
TGGGGCCTCTCGTTAGTTA -> GGGGCCTCTCGTTAGTTAC
TGGGTGACGACAGTACAGG -> GGGTGACGACAGTACAGGT
TGGTATACGATTTTTCTCG -> GGTATACGATTTTTCTCGT
TGGTATTCATATTACATGC -> GGTATTCATATTACATGCA
TGGTGGTATACGATTTTTC -> GGTGGTATACGATTTTTCT
TGGTTAAATCGTAACGTCT -> GGTTAAATCGTAACGTCTA
TGGTTACGTTGTCGCTCCG -> GGTTACGTTGTCGCTCCGA
TGGTTCCGCACATCATCTC -> GGTTCCGCACATCATCTCG
TGGTTTCCTGGTGGTATAC -> GGTTTCCTGGTGGTATACG
TGTACTGGGCCCCAAGCGT -> GTACTGGGCCCCAAGCGTT
TGTAGCGTGCGATCAACGC -> GTAGCGTGCGATCAACGCA
TGTATCACGGGGCATAATC -> GTATCACGGGGCATAATCG
TGTATTCGAGCCACCCTCC -> GTATTCGAGCCACCCTCCT
TGTCAAACTGGTTTCCTGG -> GTCAAACTGGTTTCCTGGT
TGTCAATGTGAGGCGCCGA -> GTCAATGTGAGGCGCCGAC
TGTCAGTGCCTGACTCACG -> GTCAGTGCCTGACTCACGG
TGTCCGATTTGCAGTCCGA -> GTCCGATTTGCAGTCCGAC
TGTCCGGAGTCTCAGCGGA -> GTCCGGAGTCTCAGCGGAA
TGTCCGTCCGTCCTAGTGG -> GTCCGTCCGTCCTAGTGGT
TGTCGAATTCCATCACCGA -> GTCGAATTCCATCACCGAC
TGTCGCTCCGAGTCAGGCG -> GTCGCTCCGAGTCAGGCGA
TGTCGTAACGACCCTTGCT -> GTCGTAACGACCCTTGCTA
TGTCTTGCGTGAGTCCCGA -> GTCTTGCGTGAGTCCCGAC
TGTGACGGACACCTTGTAG -> GTGACGGACACCTTGTAGC
TGTGAGAAGTGGCTGGACA -> GTGAGAAGTGGCTGGACAA
TGTGAGGCGCCGACATTAG -> GTGAGGCGCCGACATTAGG
TGTGAGGCTAGCCGTTAAG -> GTGAGGCTAGCCGTTAAGC
TGTGATCGTAAAATTAACG -> GTGATCGTAAAATTAACGC
TGTGCACACGTCTGTGCCA -> GTGCACACGTCTGTGCCAC
TGTGCCACATGATGGCTTA -> GTGCCACATGATGGCTTAC
TGTGCGACTTATTCGACAT -> GTGCGACTTATTCGACATG
TGTGCGCCTACCATGATCC -> GTGCGCCTACCATGATCCT
TGTGCGCGAGACATACATT -> GTGCGCGAGACATACATTA
TGTGGCTGGAATGCTAGTC -> GTGGCTGGAATGCTAGTCA
TGTGGGTGACGACAGTACA -> GTGGGTGACGACAGTACAG
TGTGTGAGAAGTGGCTGGA -> GTGTGAGAAGTGGCTGGAC
TGTGTTTGGAAGTTATCCA -> GTGTTTGGAAGTTATCCAT
TGTGTTTGGAGGTTGAACG -> GTGTTTGGAGGTTGAACGT
TGTGTTTGTCGTAACGACC -> GTGTTTGTCGTAACGACCC
TGTGTTTGTGAGGCTAGCC -> GTGTTTGTGAGGCTAGCCG
TGTTCACTCCGGTGAGAAT -> GTTCACTCCGGTGAGAATT
TGTTCTTGGCAAGCCACAA -> GTTCTTGGCAAGCCACAAC
TGTTTATGTGTGAGAAGTG -> GTTTATGTGTGAGAAGTGG
TGTTTGGAAGTTATCCATG -> GTTTGGAAGTTATCCATGC
TGTTTGGAGGTTGAACGTG -> GTTTGGAGGTTGAACGTGT
TGTTTGTCGTAACGACCCT -> GTTTGTCGTAACGACCCTT
TGTTTGTGAGGCTAGCCGT -> GTTTGTGAGGCTAGCCGTT
TGTTTTGGTTCCGCACATC -> GTTTTGGTTCCGCACATCA
TTAAACTTCGAAGAAAACC -> TAAACTTCGAAGAAAACCT
TTAAATCGTAACGTCTATA -> TAAATCGTAACGTCTATAC
TTAACGCGTTGAGGTCTCT -> TAACGCGTTGAGGTCTCTT
TTAAGCATCACGATCTCGT -> TAAGCATCACGATCTCGTA
TTAAGCGCGCCGATTAGTG -> TAAGCGCGCCGATTAGTGA
TTAAGCTGCTCCTATGATG -> TAAGCTGCTCCTATGATGC
TTAATATTATGTGATCGTA -> TAATATTATGTGATCGTAA
TTACAGGGTCCAAATTCCC -> TACAGGGTCCAAATTCCCG
TTACATCGTAATTTTGAGT -> TACATCGTAATTTTGAGTA
TTACATGCATACCATGGAT -> TACATGCATACCATGGATT
TTACCAACCCGGACATGGA -> TACCAACCCGGACATGGAG
TTACCACCCCAACGCTCGA -> TACCACCCCAACGCTCGAC
TTACGACCGATGTATCACG -> TACGACCGATGTATCACGG
TTACGCCCCAACCACGCGA -> TACGCCCCAACCACGCGAT
TTACGTTGTCGCTCCGAGT -> TACGTTGTCGCTCCGAGTC
TTACTACAACGTCATCGGC -> TACTACAACGTCATCGGCT
TTACTCATCTTACCACCCC -> TACTCATCTTACCACCCCA
TTAGAACATGAGTCTGCTG -> TAGAACATGAGTCTGCTGG
TTAGACAGGCTATGGGGAT -> TAGACAGGCTATGGGGATA
TTAGATGGAGTTCATACTT -> TAGATGGAGTTCATACTTC
TTAGGTGTGTTTGGAAGTT -> TAGGTGTGTTTGGAAGTTA
TTAGGTGTGTTTGGAGGTT -> TAGGTGTGTTTGGAGGTTG
TTAGGTGTGTTTGTCGTAA -> TAGGTGTGTTTGTCGTAAC
TTAGGTGTGTTTGTGAGGC -> TAGGTGTGTTTGTGAGGCT
TTAGTGAGCATGTGACGGA -> TAGTGAGCATGTGACGGAC
TTAGTTACTCATCTTACCA -> TAGTTACTCATCTTACCAC
TTATACAACTAGTTTCGTT -> TATACAACTAGTTTCGTTC
TTATACGGTACACTATGTG -> TATACGGTACACTATGTGC
TTATCCATGCGTGTTCACT -> TATCCATGCGTGTTCACTC
TTATCGGCTTCGCGTTATG -> TATCGGCTTCGCGTTATGA
TTATCGGGCGTCAAAGTGC -> TATCGGGCGTCAAAGTGCT
TTATCTTCCTTCAAGCTCG -> TATCTTCCTTCAAGCTCGA
TTATCTTTCACAAGTCGTT -> TATCTTTCACAAGTCGTTG
TTATGAAGCCGAAACTTAT -> TATGAAGCCGAAACTTATC
TTATGACTTACTACAACGT -> TATGACTTACTACAACGTC
TTATGATGATCAGTGGCAC -> TATGATGATCAGTGGCACT
TTATGTGATCGTAAAATTA -> TATGTGATCGTAAAATTAA
TTATGTGTGAGAAGTGGCT -> TATGTGTGAGAAGTGGCTG
TTATTAGATGGAGTTCATA -> TATTAGATGGAGTTCATAC
TTATTCGACATGATGCCCC -> TATTCGACATGATGCCCCA
TTCAAGCTCGAACTAGCAA -> TCAAGCTCGAACTAGCAAT
TTCACAAGTCGTTGCCTCC -> TCACAAGTCGTTGCCTCCG
TTCACTCCGGTGAGAATTA -> TCACTCCGGTGAGAATTAC
TTCATAAGCCCGCCCATGA -> TCATAAGCCCGCCCATGAA
TTCATACTTCTCCACAGCA -> TCATACTTCTCCACAGCAG
TTCATATTACATGCATACC -> TCATATTACATGCATACCA
TTCATGTGCACACGTCTGT -> TCATGTGCACACGTCTGTG
TTCCATCACCGACATTAGG -> TCCATCACCGACATTAGGT
TTCCCGATCACACGCACGA -> TCCCGATCACACGCACGAG
TTCCGCACATCATCTCGGC -> TCCGCACATCATCTCGGCC
TTCCTGGACATGCACACTG -> TCCTGGACATGCACACTGT
TTCCTGGTGGTATACGATT -> TCCTGGTGGTATACGATTT
TTCCTTCAAGCTCGAACTA -> TCCTTCAAGCTCGAACTAG
TTCGAAGAAAACCTAACTC -> TCGAAGAAAACCTAACTCA
TTCGACACCGCGTTCGACC -> TCGACACCGCGTTCGACCT
TTCGACATGATGCCCCAAG -> TCGACATGATGCCCCAAGT
TTCGACCTCAGGCCTACCT -> TCGACCTCAGGCCTACCTG
TTCGAGCCACCCTCCTTTA -> TCGAGCCACCCTCCTTTAT
TTCGCATGCGTATTTAATA -> TCGCATGCGTATTTAATAT
TTCGCGTTATGACTTACTA -> TCGCGTTATGACTTACTAC
TTCGGATTATACGGTACAC -> TCGGATTATACGGTACACT
TTCGGTTTTTCATAAGCCC -> TCGGTTTTTCATAAGCCCG
TTCGTCCTCCGCTGCCCGT -> TCGTCCTCCGCTGCCCGTC
TTCGTTCTAACGAATTCTC -> TCGTTCTAACGAATTCTCA
TTCTAACGAATTCTCAAGG -> TCTAACGAATTCTCAAGGG
TTCTCAAGGGGGTGCCCTC -> TCTCAAGGGGGTGCCCTCT
TTCTCCACAGCAGCCTTAA -> TCTCCACAGCAGCCTTAAG
TTCTCGTCTACACCCAACA -> TCTCGTCTACACCCAACAC
TTCTGCGGGCTCTAACATC -> TCTGCGGGCTCTAACATCA
TTCTGGACATGCACACTGT -> TCTGGACATGCACACTGTC
TTCTTGGCAAGCCACAACT -> TCTTGGCAAGCCACAACTG
TTGAACGTGTTTATGTGTG -> TGAACGTGTTTATGTGTGA
TTGACCAGATGCGCACGAT -> TGACCAGATGCGCACGATG
TTGACTGTATTCGAGCCAC -> TGACTGTATTCGAGCCACC
TTGAGGTCTCTTGGCTGCG -> TGAGGTCTCTTGGCTGCGG
TTGAGTAATGAAGCCTGAT -> TGAGTAATGAAGCCTGATG
TTGAGTAGGGAACTAATCG -> TGAGTAGGGAACTAATCGT
TTGCAGTCCGACATTAGGT -> TGCAGTCCGACATTAGGTG
TTGCCCAACCCTAACTGGA -> TGCCCAACCCTAACTGGAT
TTGCCCATCCGGCGCGCGA -> TGCCCATCCGGCGCGCGAG
TTGCCGACTGGACATGCAC -> TGCCGACTGGACATGCACA
TTGCCTCCGCGGAATTAAG -> TGCCTCCGCGGAATTAAGC
TTGCGTGAGTCCCGACATT -> TGCGTGAGTCCCGACATTA
TTGCTAGACGAACGTAGAC -> TGCTAGACGAACGTAGACC
TTGGAAAAAAGTCTACAAG -> TGGAAAAAAGTCTACAAGC
TTGGAAGTTATCCATGCGT -> TGGAAGTTATCCATGCGTG
TTGGACTTACAGGGTCCAA -> TGGACTTACAGGGTCCAAA
TTGGAGGTTGAACGTGTTT -> TGGAGGTTGAACGTGTTTA
TTGGCAAGCCACAACTGGC -> TGGCAAGCCACAACTGGCG
TTGGCTGCGGATGGATTCG -> TGGCTGCGGATGGATTCGT
TTGGGAACAGAAATGCGCC -> TGGGAACAGAAATGCGCCT
TTGGTTCCGCACATCATCT -> TGGTTCCGCACATCATCTC
TTGTACTGGGCCCCAAGCG -> TGTACTGGGCCCCAAGCGT
TTGTAGCGTGCGATCAACG -> TGTAGCGTGCGATCAACGC
TTGTCAGTGCCTGACTCAC -> TGTCAGTGCCTGACTCACG
TTGTCCGTCCGTCCTAGTG -> TGTCCGTCCGTCCTAGTGG
TTGTCGCTCCGAGTCAGGC -> TGTCGCTCCGAGTCAGGCG
TTGTCGTAACGACCCTTGC -> TGTCGTAACGACCCTTGCT
TTGTGAGGCTAGCCGTTAA -> TGTGAGGCTAGCCGTTAAG
TTGTGCGCCTACCATGATC -> TGTGCGCCTACCATGATCC
TTGTGCGCGAGACATACAT -> TGTGCGCGAGACATACATT
TTTAATATTATGTGATCGT -> TTAATATTATGTGATCGTA
TTTACGACCGATGTATCAC -> TTACGACCGATGTATCACG
TTTACGCCCCAACCACGCG -> TTACGCCCCAACCACGCGA
TTTATACAACTAGTTTCGT -> TTATACAACTAGTTTCGTT
TTTATGATGATCAGTGGCA -> TTATGATGATCAGTGGCAC
TTTATGTGTGAGAAGTGGC -> TTATGTGTGAGAAGTGGCT
TTTCACAAGTCGTTGCCTC -> TTCACAAGTCGTTGCCTCC
TTTCATAAGCCCGCCCATG -> TTCATAAGCCCGCCCATGA
TTTCCTGGACATGCACACT -> TTCCTGGACATGCACACTG
TTTCCTGGTGGTATACGAT -> TTCCTGGTGGTATACGATT
TTTCGCATGCGTATTTAAT -> TTCGCATGCGTATTTAATA
TTTCGTTCTAACGAATTCT -> TTCGTTCTAACGAATTCTC
TTTCTCGTCTACACCCAAC -> TTCTCGTCTACACCCAACA
TTTGAGTAGGGAACTAATC -> TTGAGTAGGGAACTAATCG
TTTGCAGTCCGACATTAGG -> TTGCAGTCCGACATTAGGT
TTTGGAAGTTATCCATGCG -> TTGGAAGTTATCCATGCGT
TTTGGAGGTTGAACGTGTT -> TTGGAGGTTGAACGTGTTT
TTTGGTTCCGCACATCATC -> TTGGTTCCGCACATCATCT
TTTGTCCGTCCGTCCTAGT -> TTGTCCGTCCGTCCTAGTG
TTTGTCGTAACGACCCTTG -> TTGTCGTAACGACCCTTGC
TTTGTGAGGCTAGCCGTTA -> TTGTGAGGCTAGCCGTTAA
TTTTACGCCCCAACCACGC -> TTTACGCCCCAACCACGCG
TTTTCATAAGCCCGCCCAT -> TTTCATAAGCCCGCCCATG
TTTTCCTGGACATGCACAC -> TTTCCTGGACATGCACACT
TTTTCTCGTCTACACCCAA -> TTTCTCGTCTACACCCAAC
TTTTGAGTAGGGAACTAAT -> TTTGAGTAGGGAACTAATC
TTTTGGTTCCGCACATCAT -> TTTGGTTCCGCACATCATC
TTTTTCATAAGCCCGCCCA -> TTTTCATAAGCCCGCCCAT
TTTTTCTCGTCTACACCCA -> TTTTCTCGTCTACACCCAA
